Ph.D.	p h d
Hon.	honorable
&	and
Mt.	Mount
Maj.	Major
Rev.	Reverend
#	hash
Gov.	governor
vs.	versus
vs	versus
dept.	department
prof.	professor
vol	volume
vol.	volume
bldg.	building
Bldg.	Building
apt.	apartment
Apt.	Apartment
World War I	World War one
World War II	World War two
κ	kappa
ω	omega
α	alpha
ν	nu
δ	delta
Δ	delta
Α	alpha
β	beta
Β	beta
χ	chi
Χ	chi
ε	epsilon
Ε	epsilon
φ	phi
Φ	phi
γ	gamma
Γ	gamma
η	eta
Η	eta
ι	iota
Ι	iota
κ	kappa
Κ	kappa
λ	lambda
Λ	lambda
μ	mu
Μ	mu
ν	nu
Ν	nu
ο	omicron
Ο	omicron
π	pi
Π	pi
θ	theta
Θ	theta
ρ	rho
Ρ	rho
σ	sigma
Σ	sigma
τ	tau
Τ	tau
υ	upsilon
Υ	upsilon
ω	omega
Ω	omega
ξ	xi
Ξ	xi
ψ	psi
Ψ	psi
ζ	zeta
Ζ	zeta
_	underscore
%	percent sign
*	asterisk
+	plus
/	slash
=	equal sign
^	circumflex
{	left brace
|	vertical bar
}	right brace
~	tilde
ltd	limited
int'l	international
$	dollar
A. A.	a a
A.A.	AA
A.A.A.	AAA
A&A	A and A
AAAI	AAAI
AAAM	AAAM
AAAs	AAA's
AAAS	AAAS
AAAW	AAAW
AABA	AABA
AaB	AAB
A. A. B.	AAB
AAB	AAB
AABC	AABC
Aabo	AABO
AABP	AABP
AABW	AABW
aac	AAC
AAC	AAC
AACAR	AACAR
AACC	AACC
AACCUP	AACCUP
AACMI	AACMI
AACNo	AACNO
AACR	AACR
AACS	AACS
AACSB	AACSB
AACTA	AACTA
AACUPR	AACUPR
A.A.D.	AAD
AADT	AADT
AADTs	AADT's
Aadu	AADU
AAEA	AAEA
AAE	AAE
AAERT	AAERT
AAF	AAF
AAFCA	AAFCA
AAFC	AAFC
AAFC's	AAFC's
AAFld	AAFLD
AAFPOA	AAFPOA
AAGPBL	AAGPBL
AAHHE	AAHHE
AAI	AAI
AAIB	AAIB
AAIP	AAIP
AAK	AAK
Aap	AAP
AAP	AAP
AAPB	AAPB
AAPC	AAPC
AAPEP	AAPEP
AAPG	AAPG
AAPM	AAPM
AAPT	AAPT
A.A.R.M.	AARM
A.B.A.	ABA
A. B.	AB
A.B.	AB
A.B.A. J.	ABAJ
A.B.C.	ABC
A. B. G.	ABG
ABG	ABG
ABH	ABH
ABHD	ABHD
Abhi	ABHI
ABK	ABK
abl	ABL
Abl	ABL
ABL	ABL
ABLV	ABLV
ABM	ABM
ABMC	ABMC
ABN	ABN
ABN's	ABN's
Abp	ABP
ABP	ABP
ABPD	ABPD
ABPI	ABPI
ABPN	ABPN
ABPP	ABPP
ABPRS	ABPRS
ABPW	ABPW
Abr	ABR
ABR	ABR
abv	ABV
ABV	ABV
ABW	ABW
ABX	ABX
Abz	ABZ
A.C.A.	ACA
ACA	ACA
A&C	A and C
A. C.	AC
A.C.	AC
acac	ACAC
Acad	ACAD
ACAD	ACAD
A.C.A.P.	ACAP
ACAP	ACAP
ACAS	ACAS
ACAZ	ACAZ
ACBA	ACBA
ACB	ACB
ACBL	ACBL
ACBS	ACBS
ACBSP	ACBSP
ACCA	ACCA
ACC	ACC
ACCC	ACCC
ACCJ	ACCJ
ACC&S	ACC and S
ACC's	ACC's
ACCS	ACCS
ACD	ACD
ACDC	ACDC
A.C. D.F.C. A.F.C.	ACDFCAFC
A.C.E.	ACE
ACF	ACF
ACFE	ACFE
A.C.G.	ACG
ACG	ACG
ACGIH's	ACGIH's
A.C.H.	ACH
ACH	ACH
ACHP	ACHP
ACHR	ACHR
ACHRE	ACHRE
Achs	ACH's
ACHS	ACHS
ACIA	ACIA
ACI	ACI
ACICS	ACICS
ACIGA	ACIGA
ACIP	ACIP
Acis	ACI's
ACIS	ACIS
ACLA	ACLA
A.C.L.	ACL
ACL	ACL
A.C.L.N.	ACLN
acls	ACLS
ACL's	ACL's
ACLS	ACLS
ACLU	ACLU
ACM	ACM
ACMI	ACMI
ACMs	ACM's
ACN	ACN
ACO's	ACO's
AcpA	ACPA
ACP	ACP
AcpB	ACPB
ACPI	ACPI
ACPO	ACPO
ACPP	ACPP
ACPSEM	ACPSEM
acq	ACQ
A&CR	A and CR
ACR	ACR
ACRPS	ACRPS
ACSA	ACSA
ACSAC	ACSAC
ACSBR	ACSBR
ACSCN	ACSCN
ACSEL	ACSEL
ACSIA	ACSIA
ACSI	ACSI
AcSOC	ACSOC
ACSR	ACSR
ACSS	ACSS
ACSS's	ACSS's
A.C.T.	ACT
A.C.T.A.F.L.	ACTAFL
acu	ACU
ACU	ACU
ACU's	ACU's
ACUS	ACUS
ACUV	ACUV
ACV	ACV
ACWA	ACWA
AC&W	AC and W
ACW	ACW
ACWM	ACWM
ACWS	ACWS
Acy	ACY
ADAA	ADAA
A&D	A and D
Adab	ADAB
ADAC	ADAC
A. D.	AD
A.D.	AD
A.D.A.M.	adam
AdaSL	ADASL
ADATA	ADATA
ADBAC	ADBAC
ADB	ADB
ADBGR	ADBGR
ADBICA	ADBICA
ADCA	ADCA
AdC	ADC
A.D.C.	ADC
ADC	ADC
ADCAF	ADCAF
ADCC	ADCC
ADC's	ADC's
ADCs	ADC's
ADCY	ADCY
ADDA	ADDA
AD&D	AD and D
ADF	ADF
ADF's	ADF's
ADFS	ADFS
ADG	ADG
ADGB	ADGB
ADH	ADH
ADHD	ADHD
ADHM	ADHM
ADHS	ADHS
ADIAC	ADIAC
AdK	ADK
ADK	ADK
Adl	ADL
ADL	ADL
ADLL	ADLL
ADLs	ADL's
A.D.M.A.C.	ADMAC
adm	ADM
Adm	ADM
ADM	ADM
ADMK	ADMK
admn	ADMN
ADMN	ADMN
ADNAC	ADNAC
ADNEC	ADNEC
ADNs	ADN's
AdP	ADP
A.D.P.	ADP
ADP	ADP
ADPCM	ADPCM
ADPF	ADPF
ADQ	ADQ
ADQ's	ADQ's
ADR	ADR
ADRC	ADRC
ADRP	ADRP
ADRs	ADR's
ADSB	ADSB
ADSL	ADSL
ADSR	ADSR
ADSRs	ADSR's
ADSs	ADS's
ADT	ADT
ADTG	ADTG
Adwa	ADWA
ADWC	ADWC
ADX	ADX
AEA	AEA
A&E	A and E
A. E.	AE
A.E.	AE
AEBN	AEBN
A.E.C.	AEC
AEC	AEC
AECL	AECL
AECR	AECR
AEC's	AEC's
Aed	AED
AED	AED
AEE	AEE
AEF	AEF
AEG	AEG
A.E.G.I.S.	AEGIS
aegte	AEGTE
AEHL	AEHL
AEIA	AEIA
AEI	AEI
AEIOU	AEIOU
Aeka	AEKA
AEK	AEK
ael	AEL
AEL	AEL
Aema	AEMA
AEM	AEM
aen	AEN
AEO	AEO
AEPA	AEPA
AEP	AEP
aere	AERE
AEre	AERE
AErn	AERN
AERN	AERN
Aert	AERT
AESA	AESA
Aes	AE's
AES	AES
aet	AET
AET	AET
AETC	AETC
AEU	AEU
AEV	AEV
AEW	AEW
AEX	AEX
Afa	AFA
AFA	AFA
af	AF
Af	AF
A. F.	AF
A.F.	AF
AF	AF
Afaf	AFAF
AFAP	AFAP
AFB	AFB
AFCA	AFCA
afc	AFC
A.F.C.	AFC
AFC	AFC
AFCEC	AFCEC
AFCO	AFCO
AFC's	AFC's
AFCS	AFCS
AFCSThe	AFCSTHE
Afd	AFD
AfD	AFD
AfDB	AFDB
AFDD	AFDD
Afe	AFE
AFE	AFE
Aff	AFF
AFF	AFF
AFG	AFG
AFGM	AFGM
AFH	AFH
AFIA	AFIA
Afi	AFI
AFI	AFI
AFIP	AFIP
Afiq	AFIQ
AFI's	AFI's
AFJ	AFJ
A.F.L.	AFL
AFL	AFL
AFLEG	AFLEG
AFLPA	AFLPA
AFLP	AFLP
AFL's	AFL's
AFLUA	AFLUA
A. F.M.A.	AFMA
AFM	AFM
AFMC	AFMC
AFMs	AFM's
AFN	AFN
AFNET	AFNET
AFNOR	AFNOR
AfNS	AFNS
Afo	AFO
AFO	AFO
AFOP	AFOP
AFP	AFP
AFRA	AFRA
Afr	AFR
AFR	AFR
AFRC	AFRC
AFRL	AFRL
AFROTC	AFROTC
AFRTS	AFRTS
AFS	AFS
AFSC	AFSC
AFSPC	AFSPC
A. F. T.	AFT
AFTRA	AFTRA
AFTRA's	AFTRA's
AFTRS	AFTRS
AFV	AFV
AFW	AFW
AFWS	AFWS
AFX	AFX
A. G.	AG
A.G.	AG
AGB	AGB
AGC	AGC
Agco	AGCO
AGCO	AGCO
Agda	AGDA
AGD	AGD
A.G.E.	AGE
AGF	AGF
AG&G	AG and G
agg	AGG
Agi	AGI
AGI	AGI
AGID	AGID
AGIR	AGIR
Agis	AGI's
A.G.J.	AGJ
A. G. K.	AGK
AGL	AGL
agli	AGLI
AGM	AGM
Agn	AGN
AgN	AGN
AGN	AGN
AGNs	AGN's
A.G.P.	AGP
AGP	AGP
AGPL	AGPL
AGPS	AGPS
AGPW	AGPW
AGRs	AGR's
AGS	AGS
AGSM	AGSM
Agsu	AGSU
agt	AGT
AGT	AGT
Agte	AGTE
Agu	AGU
AGU	AGU
AGV	AGV
A.H.A.	AHA
A. H.	AH
A.H.	AH
A. H. C.	AHC
AHC	AHC
AHD	AHD
Ahdhra	AHDHRA
AHDR	AHDR
ahe	AHE
Ahe	AHE
AHEC	AHEC
AHF	AHF
Ahirs	AHIR's
Ahk	AHK
AHL's	AHL's
AHP	AHP
AHRC	AHRC
AHRS	AHRS
AHSAA	AHSAA
Ahsa'i	AHSAI
Ahta	AHTA
aht	AHT
AHT	AHT
AHTD	AHTD
Ahu	AHU
Ahva	AHVA
AHV	AHV
AIAA	AIAA
A.I.A.	AIA
A&I	A and I
A. I.	AI
A.I.	AI
AI	AI
AIAP	AIAP
Aias	AIA's
AIAS	AIAS
AIATSIS	AIATSIS
AIAW	AIAW
AIAWU	AIAWU
A.I.B.A.	AIBA
AIB	AIB
AIBO's	AIBO's
AIBS	AIBS
AIC	AIC
AICAR	AICAR
AICC	AICC
AICCCR	AICCCR
aici	AICI
Aicme	AICME
AICN	AICN
AICPA	AICPA
AICP	AICP
AICPS	AICPS
AICs	AIC's
AICTE	AICTE
AICUF	AICUF
AIDA	AIDA
AIDN	AIDN
AIEC	AIEC
AIEE	AIEE
Aiel	AIEL
AIEP	AIEP
AIFA	AIFA
AIF	AIF
AIFB	AIFB
Aife	AIFE
AIFF	AIFF
AIFM	AIFM
AIFMD	AIFMD
AiG	AIG
AIG	AIG
Aigis	AIGI's
AIHA	AIHA
AIH	AIH
AIHL	AIHL
AIIMS	AIIMS
Aija	AIJA
Aik	AIK
AIK	AIK
AIKR	AIKR
A.I.M.	AIM
AIP	AIP
A.I.R.	AIR
AIs	AI's
AISC	AISC
AISD	AISD
AISRI	AISRI
Aist	AIST
AIST	AIST
AIT's	AIT's
Aitu	AITU
Aiud	AIUD
aius	AIUS
AIVC	AIVC
AIW	AIW
AIX	AIX
A. J.	AJ
A.J.	AJ
Ajba	AJBA
A.J.B.	AJB
AJC	AJC
A.J.E.	AJE
A.J.G.C.	AJGC
A. J. J.	AJJ
A.J.K.	AJK
AJK	AJK
AJKF	AJKF
AJL	AJL
A. J. M.	AJM
Ajmi	AJMI
AJN	AJN
AJO	AJO
Ajok	AJOK
A. J. P.	AJP
A.J.P.	AJP
AJPW	AJPW
A.J.R.	AJR
AJR	AJR
Ajsa	AJSA
A.J.S.	AJS
AJS	AJS
A. J. T.	AJT
A.J.T.	AJT
AJT	AJT
Aju	AJU
AJUFE	AJUFE
AJUSCO	AJUSCO
AJV	AJV
AJW	AJW
AJWRC	AJWRC
Akaa	AKAA
a.k.a.	AKA
aka.	AKA
aka	AKA
Aka.	AKA
Aka	AKA
AKA	AKA
A&K	A and K
A. K.	AK
A.K.	AK
AK	AK
AKAP	AKAP
AKAPs	AKAP's
akas	AKA's
AKAs	AKA's
AKB	AKB
AKC	AKC
AKCR	AKCR
AKD	AKD
AKG	AKG
AKG's	AKG's
akh	AKH
AKH	AKH
AKHS	AKHS
AKM	AKM
AKN	AKN
Akpa	AKPA
AKP	AKP
AKPD	AKPD
AKQA	AKQA
AKR	AKR
A.K.S.	AKS
AKS	AKS
Aku	AKU
AKU	AKU
AKW	AKW
A&L	A and L
A. L.	AL
A.L.	AL
ALDF	ALDF
ALDH	ALDH
ALDS	ALDS
ALDT	ALDT
ALFASID	ALFASID
ALFIDI	ALFIDI
ALFTP	ALFTP
Alh	ALH
ALH	ALH
A. L. M.	ALM
A.L.P.	ALP
ALPG	ALPG
ALR	ALR
ALSC	ALSC
ALSF	ALSF
ALSP	ALSP
ALUs	ALU's
A.L.V.	ALV
ALVF	ALVF
ALW	ALW
ALWS	ALWS
AMAA	AMAA
A'ma	AMA
A&M	A and M
a.m.	AM
a.m	AM
A. M.	AM
A.M.	AM
AMAP	AMAP
AMARC	AMARC
AMAs	AMA's
amb	AMB
Amb	AMB
AMB	AMB
AmBX	AMBX
A.M.C.	AMC
AMC	AMC
AMC's	AMC's
AMCs	AMC's
Amda	AMDA
Amd	AMD
AMD	AMD
AMDH	AMDH
AMDISA	AMDISA
AMD's	AMD's
A.M.E.	AME
AMF	AMF
AM&FM	AM and FM
A. M. G.	AMG
AMG	AMG
AMGTV	AMGTV
Amha	AMHA
AMH	AMH
A.M.H.S.	AMHS
A. M. J.	AMJ
AMJ	AMJ
A. M. K.	AMK
A.M.K.	AMK
AMK	AMK
aml	AML
AML	AML
Amli	AMLI
AMLS	AMLS
Amlwch	AMLWCH
Amm	AMM
A. M. M.	AMM
AMM	AMM
AMMAYI	AMMAYI
AMMB	AMMB
AMMK	AMMK
AMN	AMN
AMNH	AMNH
AMNRL	AMNRL
AM&O	AM and O
AMPK	AMPK
AMPL	AMPL
AMP's	AMP's
Ampt	AMPT
AMPTP	AMPTP
amr	AMR
A. M. R.	AMR
AMREF	AMREF
AMSA	AMSA
A&M's	A and M's
Ams'	AM's
amsl	AMSL
AMSO's	AMSO's
AMSRS	AMSRS
AMS's	AMS's
AMSS	AMSS
AMSU	AMSU
Amta	AMTA
amt	AMT
Amt	AMT
A.M.T.	AMT
AMT	AMT
AMTB	AMTB
AMTPAT	AMTPAT
Amts	AMT's
AMTV	AMTV
Amu	AMU
AMU	AMU
AMU's	AMU's
A.M.V.M.	AMVM
AMW	AMW
AMX	AMX
AMYF	AMYF
A. N.	AN
A.N.	AN
ANB	ANB
ANBO	ANBO
ANC	ANC
ANCC	ANCC
ANC's	ANC's
andFHL	ANDFHL
ANDOC	ANDOC
ANDP	ANDP
ANDPOP	ANDPOP
andPPP	ANDPPP
Anej	ANEJ
ANELFA	ANELFA
ANF	ANF
ANFIS	ANFIS
ANFP's	ANFP's
ANGB	ANGB
ANGPTL	ANGPTL
ANGRAU	ANGRAU
Angti	ANGTI
Angu	ANGU
Anhe	ANHE
ANI	ANI
ANL	ANL
ANM	ANM
ANP	ANP
ANPP	ANPP
ANPR	ANPR
Anr	ANR
ANR	ANR
ANRC	ANRC
ANREF's	ANREF's
Anrep	ANREP
ANRS	ANRS
ANRW	ANRW
A.N.S.	ANS
ANS	ANS
ANSF	ANSF
ANTB	ANTB
ANTM	ANTM
ANTV	ANTV
ANUGA	ANUGA
ANWB	ANWB
ANX	ANX
ANZ	ANZ
A&O	A and O
AOA	AOA
AOAC	AOAC
A. O.	AO
A.O.	AO
AOB	AOB
AOC	AOC
AOCB	AOCB
AOCCs	AOCC's
AOCE	AOCE
AOD	AOD
Aodh	AODH
Aodla	AODLA
AODV	AODV
AOE	AOE
AOGCC	AOGCC
Aogo	AOGO
AOH	AOH
Aoke	AOKE
Aoko	AOKO
AOKP	AOKP
Aola	AOLA
Aol	AOL
AOL	AOL
AOL's	AOL's
AOLTV	AOLTV
AOM	AOM
AOMC	AOMC
AONB	AONB
Aone	AONE
Aoni	AONI
Aoos	AOO's
AOPA	AOPA
AOP	AOP
aor	AOR
AOR	AOR
AORs	AOR's
AORS	AORS
aos	AOS
AoS	AOS
AOS	AOS
Aotus	AOTU's
AOTW	AOTW
aov	AOV
aovf	AOVF
AOWC	AOWC
A&P	A and P
A. P.	AP
A.P.	AP
APBA	APBA
APB	APB
APBL	APBL
APCA	APCA
Apc	APC
APC	APC
APCCR	APCCR
APCh	APCH
APCR	APCR
APCRDA	APCRDA
APC's	APC's
APCs	APC's
APDA	APDA
APD	APD
APDM	APDM
APEGBC	APEGBC
APFA	APFA
APF	APF
APFCT	APFCT
APFOL	APFOL
APFSDS	APFSDS
APFUTU	APFUTU
apg	APG
APG	APG
APGAW	APGAW
Aph	APH
A.P.H.	APH
APH	APH
APHEDA	APHEDA
APHL	APHL
Apiao	APIAO
Api	API
APi	API
API	API
Apic	APIC
APICv	APICV
API's	API's
A.P.J.	APJ
APJ	APJ
Apl	APL
APL	APL
APLP	APLP
APLS	APLS
Aplu	APLU
APM	APM
APML	APML
APMR	APMR
APMSO	APMSO
APN	APN
A.P.N.C.	APNC
Apphttp	APPHTTP
Appl	APPL
APPO's	APPO's
appr	APPR
Appts	APPT's
appu	APPU
Appu	APPU
APRA's	APRA's
APRC	APRC
APR's	APR's
APRS	APRS
APRST	APRST
A&P's	A and P's
Aps	AP's
APs	AP's
APS	APS
APSF	APSF
APSL	APSL
APTA	APTA
AP&T	AP and T
APW	APW
APX	APX
APXS	APXS
Aqa	AQA
AQA	AQA
AQC	AQC
AQI	AQI
Aql	AQL
AQP	AQP
Aqr	AQR
A&R	A and R
ARA	ARA
A. R.	AR
A.R.	AR
A.R.B.	ARB
ARD	ARD
ARDF	ARDF
A.R.E.	ARE
A.R.F.	ARF
ARF	ARF
A.R.G.	ARG
ArgR	ARGR
ARGs	ARG's
ARGT	ARGT
ArH	ARH
ARJ	ARJ
ARL	ARL
ARLFC	ARLFC
A. R. M.	ARM
ARMv	ARMV
Arnd	ARND
ARNG	ARNG
ARNT	ARNT
A.R.P.	ARP
ARQ	ARQ
ARTL	ARTL
A.R.U.	ARU
arv	ARV
Arv	ARV
ARV	ARV
ARVD	ARVD
ARVN	ARVN
ARW	ARW
Arwi	ARWI
ARWU	ARWU
A.S.A.	ASA
ASA	ASA
As'ad	ASAD
Asai	ASAI
Asao	ASAO
A.s	A's
A. S.	AS
A.S.	AS
ASAS	ASAS
Asasp	ASASP
ASAU	ASAU
A.S.B.	ASB
ASB	ASB
ASBDA	ASBDA
asbl	ASBL
ASBM	ASBM
ASBMH	ASBMH
ASBO	ASBO
A.S.C.	ASC
ASC	ASC
ASCB	ASCB
ASCE	ASCE
asci	ASCI
Asci	ASCI
ASCP	ASCP
ASCW	ASCW
A.S.D.	ASD
ASD	ASD
ASDIC	ASDIC
Asdis	ASDI's
ASE	ASE
ASEC	ASEC
ASEE	ASEE
ASEF	ASEF
ASFA	ASFA
ASF	ASF
Asfi	ASFI
ASGA	ASGA
ASG	ASG
ASGC	ASGC
ASGE	ASGE
ASGS	ASGS
A. S. H.	ASH
A.S.I.	ASI
ASL	ASL
A.S.M.	ASM
ASM	ASM
ASMD	ASMD
ASME	ASME
ASMIK	ASMIK
ASML	ASML
ASMPH	ASMPH
ASMSU	ASMSU
Asn	ASN
ASN	ASN
Aso	ASO
ASO	ASO
ASP	ASP
ASPCA	ASPCA
Aspe	ASPE
ASPTS	ASPTS
Asr	ASR
ASR	ASR
Assn	ASSN
assoc	ASSOC
Assoc	ASSOC
ASSPs	ASSP's
ASSR	ASSR
Asst	ASST
ASSU	ASSU
A. S. T.	AST
ASTAT	ASTAT
ASTCL	ASTCL
Aste	ASTE
ASTE	ASTE
ASTM	ASTM
ASTR	ASTR
Astt	ASTT
A.S.U.	ASU
ASU	ASU
A.S.V.	ASV
ASV	ASV
Aswa	ASWA
ASW	ASW
ASX	ASX
A&T	A and T
atac	ATAC
Atac	ATAC
Atad	ATAD
Ata's	ATA's
Atas	ATA's
ATA's	ATA's
A. T.	AT
A.T.	AT
ATBF	ATBF
ATBs	ATB's
atc	ATC
A.T.C.	ATC
ATC	ATC
atcc	ATCC
ATCC	ATCC
ATCDE	ATCDE
ATCL	ATCL
ATDC	ATDC
ATF	ATF
Atg	ATG
ATG	ATG
ATGM	ATGM
ath	ATH
Ath	ATH
ATH	ATH
ATHN	ATHN
ATIA	ATIA
Atia's	ATIA's
Ati	ATI
ATi	ATI
ATI	ATI
Atid	ATID
Atiiq	ATIIQ
Atil	ATIL
ATINC	ATINC
ATIP	ATIP
Atiq	ATIQ
Ativ	ATIV
ATJ	ATJ
Atka	ATKA
ATK	ATK
ATKN	ATKN
ATK's	ATK's
Atl	ATL
ATL	ATL
Atli	ATLI
ATLY	ATLY
A.T.M.A.	ATMA
atm	ATM
Atm	ATM
ATM	ATM
ATMs	ATM's
ATN	ATN
ATO	ATO
Atos	ATO's
ATO's	ATO's
ATOs	ATO's
ATOS	ATOS
ATP	ATP
atpB	ATPB
A.T.Q.	ATQ
ATR	ATR
atri	ATRI
Atri	ATRI
ATRP	ATRP
A&T's	A and T's
A.T.s	AT's
A.T.S.	ATS
ATS	ATS
ATSC	ATSC
ATSDR	ATSDR
AT&SF	AT and SF
ATSF	ATSF
ATSIC	ATSIC
AT&T	AT and T
attd	ATTD
ATTESA	ATTESA
ATTF	ATTF
AT&T's	AT and T's
ATTS	ATTS
ATTWI	ATTWI
ATTWX's	ATTWX's
ATU's	ATU's
atv	ATV
ATV	ATV
ATV's	ATV's
ATVs	ATV's
ATW	ATW
AtxA	ATXA
ATX	ATX
ATXN	ATXN
A. U.	AU
A.U.	AU
Aub	AUB
Aubl	AUBL
AUC	AUC
AUVs	AUV's
Auw	AUW
avab	AVAB
AVAC	AVAC
A. V.	AV
A.V.	AV
AVCA	AVCA
AVC	AVC
AVCHD	AVCHD
AVCs	AVC's
AVCS	AVCS
AVD	AVD
avg	AVG
AVG	AVG
AVK	AVK
AVL	AVL
A. V. M.	AVM
AVM	AVM
Avn	AVN
AVN	AVN
Avo	AVO
AvP	AVP
AVP	AVP
AVR	AVR
AVRs	AVR's
AVSA	AVSA
Avs'	AV's
Avs	AV's
AVS	AVS
AVSM	AVSM
AVU	AVU
avvo	AVVO
AVX	AVX
Awa	AWA
A. W. A.	AWA
AWA	AWA
A. W. A. M.	AWAM
AWAs	AWA's
A. W.	AW
A.W.	AW
A. W. B.	AWB
A.W.B.	AWB
AWB	AWB
AWB's	AWB's
A.W.C.	AWC
AWC	AWC
AWD	AWD
A. W. F.	AWF
AWG	AWG
AWGIE	AWGIE
AWGN	AWGN
A. W. H.	AWH
AWHL	AWHL
AWI	AWI
AWM	AWM
Awo	AWO
AWP	AWP
AWP's	AWP's
AWR	AWR
AWSA	AWSA
AWU	AWU
Awwa	AWWA
AXAF	AXAF
A. X.	AX
AXS	AXS
AXV	AXV
A. Y.	AY
A.Y.	AY
AYF	AYF
AYK	AYK
AYP	AYP
A. Z.	AZ
A.Z.	AZ
AZE	AZE
Azg	AZG
Azi	AZI
AZI	AZI
AZL	AZL
azm	AZM
AZN	AZN
AZS	AZS
AZSTA's	AZSTA's
AZT	AZT
AzTV	AZTV
Baad	BAAD
BAAG	BAAG
Ba'al	BAAL
Baal	BAAL
BAAL	BAAL
Baam	BAAM
Baap	BAAP
ba'as	BAA's
Baat	BAAT
Ba'ath	BAATH
B. A.	BA
B.A.	BA
B&A	B and A
Bac	BAC
B.A.C.	BAC
BAC	BAC
bae	BAE
Bae	BAE
BAe	BAE
BAE	BAE
BAFA	BAFA
BAF	BAF
B.A.R.	BAR
BARV	BARV
BASCA	BASCA
BASEC	BASEC
BASF	BASF
B.A.S.P.	BASP
BATVG	BATVG
Bauw	BAUW
B'Av	BAV
BAV	BAV
BBA	BBA
BBAG	BBAG
B&B	B and B
bb	BB
B. B.	BB
B.B.	BB
BB	BB
BBB	BBB
bbc	BBC
B.B.C.	BBC
BBC	BBC
BBCBBC	BBCBBC
BB&CI	BB and CI
BBC&PJR	BBC and PJR
BBC's	BBC's
B.B.D.	BBD
BBDO	BBDO
BBE	BBE
BBF	BBF
BBFC	BBFC
BBFF	BBFF
BBG	BBG
BBH	BBH
BBI	BBI
BBK	BBK
BBKL	BBKL
BBLB	BBLB
BBL	BBL
BBM	BBM
BBMP	BBMP
BBNG	BBNG
BBN's	BBN's
BBO	BBO
BBP	BBP
BBQ'er	BBQER
B&Bs	B and B's
BB&S	BB and S
BBS	BBS
BBSes	BBSE's
BBS's	BBS's
BB&T	BB and T
BBT	BBT
BBTV	BBTV
BBU	BBU
BBVA	BBVA
BbvCI	BBVCI
BBV's	BBV's
BBWAA	BBWAA
BBWA	BBWA
BBWR's	BBWR's
BBYA	BBYA
BBYO	BBYO
BCA	BCA
BCAD	BCAD
BCAM	BCAM
BCATP	BCATP
BCBA	BCBA
BCB	BCB
bc	BC
B. C.	BC
B.C.	BC
BC	BC
BCCA	BCCA
BCC	BCC
BCCCA	BCCCA
Bcci	BCCI
BCCI	BCCI
BCCP	BCCP
BCC's	BCC's
BCDA	BCDA
BCD	BCD
BCEA	BCEA
BCE	BCE
BCE's	BCE's
BCF	BCF
BCG	BCG
BCG's	BCG's
BCHL	BCHL
BCHR's	BCHR's
BCHS	BCHS
BCI	BCI
B. C. J.	BCJ
BCL	BCL
BCLR	BCLR
BCMA	BCMA
BCM	BCM
BCMG	BCMG
BCMHS	BCMHS
BCMS	BCMS
BCN	BCN
BCN's	BCN's
BCP	BCP
BCPM	BCPM
BCR	BCR
BCRF's	BCRF's
B.C.'s	BC's
BC's	BC's
BCs	BC's
BCS	BCS
BCSC	BCSC
BCSic	BCSIC
BCSN	BCSN
BCT	BCT
BCTC	BCTC
BCU	BCU
BCYP	BCYP
BdA	BDA
BDA	BDA
bd	BD
B. D.	BD
B.D.	BD
BD	BD
BDBL	BDBL
BDC	BDC
BDC's	BDC's
BDD	BDD
Bde	BDE
B. D. E.	BDE
BDE	BDE
BDF	BDF
BDI	BDI
BDJ	BDJ
BDK	BDK
BDK's	BDK's
BDMI	BDMI
BDN	BDN
BDNF	BDNF
BDO	BDO
BDO's	BDO's
BDOS	BDOS
BDP	BDP
BDR	BDR
bds	BDS
BDS	BDS
BDSM	BDSM
BdU	BDU
BDU	BDU
BDV	BDV
B. D. W.	BDW
B.E.A.	BEA
B. E.	BE
B.E.	BE
Bedw	BEDW
B.E.E.	BEE
bef	BEF
B.E.F.	BEF
BEF	BEF
BEF's	BEF's
bei	BEI
Bei	BEI
Beih	BEIH
BEIR	BEIR
Beis	BEI's
bej	BEJ
B.E.M.	BEM
BEMs	BEM's
BEP	BEP
Ber	BER
BER	BER
Bes	BE's
B.E.S.	BES
BES	BES
B.F.A.	BFA
BFA	BFA
bf	BF
B. F.	BF
B.F.	BF
BF	BF
BFCA	BFCA
BFC	BFC
BFC's	BFC's
BFDG	BFDG
BFES	BFES
BFF	BFF
BFFs	BFF's
B. F. G.	BFG
BFG	BFG
BFG's	BFG's
BFI	BFI
BFI's	BFI's
BFJA	BFJA
BFKL	BFKL
BFL	BFL
BFM	BFM
BFO	BFO
BFRA	BFRA
BFR	BFR
BFSA	BFSA
BFS	BFS
BFT	BFT
BFU	BFU
bfy	BFY
BGAB	BGAB
BGA	BGA
BGB	BGB
B. G.	BG
B.G.	BG
BGC	BGC
BGCI	BGCI
BGD	BGD
BGEA	BGEA
B. G. E.	BGE
BGH	BGH
B. G. J. S.	BGJS
BGL	BGL
BglII	BGLII
BGM	BGM
BGP	BGP
BGRA	BGRA
BGR	BGR
BGRC	BGRC
BGRSO	BGRSO
bgs	BGS
B.G.S.	BGS
BGS	BGS
BGSU	BGSU
BGT	BGT
Bgy	BGY
Bha	BHA
B&H	B and H
B. H.	BH
B.H.	BH
BHCC	BHCC
BHDP	BHDP
BH&E	BH and E
Bhe	BHE
BHL	BHL
BHMA	BHMA
BHMO	BHMO
BHMs	BHM's
BHMT	BHMT
BHO	BHO
B. H. P.	BHP
BHP	BHP
BHRT	BHRT
BHS	BHS
BHSN	BHSN
BHSU	BHSU
bhttp	BHTTP
BHU	BHU
BHUSD	BHUSD
BHVS	BHVS
B. I.	BI
B.I.	BI
Bie	BIE
BIE	BIE
biedt	BIEDT
Biem	BIEM
B.I.G.	BIG
B.I.G.'s	BIG's
BiH	BIH
BIH	BIH
B.I.O.L.A.	BIOLA
B. J.	BJ
B.J.	BJ
BJCC	BJCC
BJCP	BJCP
BJD	BJD
B.J.F.	BJF
B. J. I.	BJI
BJJ	BJJ
BJP	BJP
BJP's	BJP's
BJPs	BJP's
BJPS	BJPS
B.J.'s	BJ's
B.J.T.	BJT
BJT	BJT
BJU	BJU
BJY	BJY
B.K.A.	BKA
B&K	B and K
B. K.	BK
B.K.	BK
BKCa	BKCA
BKC	BKC
BKF	BKF
BKI	BKI
BKN's	BKN's
BKO	BKO
B.K.R.	BKR
BKR	BKR
BK's	BK's
BKS	BKS
BKT	BKT
BKTV	BKTV
BKV	BKV
B. L.	BL
B.L.	BL
BL	BL
BLC	BLC
BLCC	BLCC
BLCN	BLCN
ble	BLE
bleg	BLEG
blev	BLEV
BLG	BLG
bli	BLI
BLI	BLI
Blla	BLLA
BLL	BLL
BLM	BLM
BLMC	BLMC
BLOU's	BLOU's
BLPP	BLPP
BLR	BLR
BLRC	BLRC
BLR&D	BLR and D
B.L.S.	BLS
BLS	BLS
BLT	BLT
BLTF	BLTF
BLTs	BLT's
BLV	BLV
BMAA	BMAA
B.M.A.	BMA
BMA	BMA
BMAL	BMAL
BMARC	BMARC
BMA's	BMA's
B&M	B and M
BMB	BMB
B. M.	BM
B.M.	BM
BMCA	BMCA
B.M.C.	BMC
BMC	BMC
bmd	BMD
BMD	BMD
BME	BME
BMF	BMF
BMG	BMG
BMHS	BMHS
bmi	BMI
BMI	BMI
BMIC	BMIC
BMIR	BMIR
BMI's	BMI's
BMIT	BMIT
BMJ	BMJ
BMK	BMK
BMKG	BMKG
BMMO	BMMO
BMNA	BMNA
BMNH	BMNH
BMNP	BMNP
BMO	BMO
BMP	BMP
BMPs	BMP's
BMR	BMR
BMRs	BMR's
BMSA	BMSA
B.M.S.	BMS
BMS	BMS
bmt	BMT
B. M. T.	BMT
B.M.T.	BMT
BMT	BMT
BMT's	BMT's
BMU	BMU
B.M.V.	BMV
BMV	BMV
B. M. W.	BMW
BMW	BMW
BMW M	BMW
BMW's	BMW's
BMX	BMX
BNA	BNA
B&N	B and N
bnb	BNB
BNB	BNB
B. N.	BN
B.N.	BN
BNC	BNC
BNCI	BNCI
BNCM	BNCM
BNCT	BNCT
BND	BND
BNDY	BNDY
BNET	BNET
BNF	BNF
BNFL	BNFL
BNI	BNI
BNIC	BNIC
BNL	BNL
BNO	BNO
BNP	BNP
BNR	BNR
BNRC	BNRC
BNS	BNS
BNSF	BNSF
BNST	BNST
BNT	BNT
BNU	BNU
BNY	BNY
BNZ	BNZ
Boac	BOAC
BOAC	BOAC
B&O	B and O
B. O.	BO
B.O.	BO
Boc	BOC
BoC	BOC
BOC	BOC
BOCs	BOC's
BOCS	BOCS
boj	BOJ
Boj	BOJ
BOJ	BOJ
B.O.M.B.	BOMB
B&O's	B and O's
B.O.S.	BOS
BOYZZ	BOYZZ
BPA	BPA
BPB	BPB
bp	BP
B. P.	BP
B.P.	BP
BP	BP
BPC	BPC
BPD	BPD
BPER	BPER
B.P.H.	BPH
BPI	BPI
BPJ	BPJ
BPK	BPK
bpl	BPL
BPL	BPL
B. P. M.	BPM
BPM	BPM
BPMN	BPMN
B.P.N.	BPN
BPN	BPN
B.P.O.	BPO
BPO	BPO
BPPA	BPPA
BPP	BPP
BPR	BPR
B.P.R.D.	BPRD
BPRD	BPRD
BPSA	BPSA
BP's	BP's
BPS	BPS
BPSK	BPSK
BPUP	BPUP
BPV	BPV
BPY	BPY
B&Q	B and Q
BQB	BQB
B. Q.	BQ
BRAC's	BRAC's
BRAM	BRAM
BRBDP	BRBDP
Brbic	BRBIC
B. R.	BR
B.R.	BR
BRBR	BRBR
BRBs	BRB's
BRCA	BRCA
BRC	BRC
BRCC	BRCC
BRD	BRD
BRF	BRF
BRGF	BRGF
BRGM	BRGM
BRHS	BRHS
B.R.I.C.K.	BRICK
BRK	BRK
BRL	BRL
BRM	BRM
BRMS	BRMS
BRN	BRN
BRNC	BRNC
Brne	BRNE
Brno	BRNO
BRNV	BRNV
BRP	BRP
BRPS	BRPS
BRRA	BRRA
BRS	BRS
BRSCC's	BRSCC's
BRT	BRT
BRTs	BRT's
BRTS	BRTS
BRVM	BRVM
BRW	BRW
BRWK	BRWK
Brza	BRZA
BRZ	BRZ
brzu	BRZU
brzy	BRZY
Brzyk	BRZYK
BSAA	BSAA
B.S.A.	BSA
BSA	BSA
BSAC	BSAC
BsaL	BSAL
BSBA	BSBA
BSB	BSB
BSBI	BSBI
B. s	B's
B.'s	B's
Bs	B's
B. S.	BS
B.S.	BS
BS	BS
B.S.C.	BSC
BSC	BSC
BSCL	BSCL
bsd	BSD
BSD	BSD
BSDE	BSDE
BSE	BSE
BSET	BSET
BSFA	BSFA
BSF	BSF
BSG	BSG
BSH	BSH
BSIB	BSIB
BSI	BSI
BSK	BSK
BSL	BSL
BSM	BSM
BSME	BSME
BSN	BSN
BSNL	BSNL
BSOG	BSOG
BSPA	BSPA
BSP	BSP
BSPP	BSPP
BSR	BSR
BSRN	BSRN
BSS	BSS
BSU	BSU
BSV	BSV
BSX	BSX
BTA	BTA
BTAF	BTAF
BTB	BTB
BTBD	BTBD
bt	BT
B. T.	BT
B.T.	BT
BT	BT
BTCA	BTCA
BTC	BTC
BTCC	BTCC
BTD	BTD
BTF	BTF
BTG	BTG
BTH	BTH
BTK	BTK
BTL	BTL
BTM	BTM
BTN	BTN
BTNK	BTNK
BTOB	BTOB
BTO	BTO
BTP	BTP
BTRC	BTRC
BTRDA	BTRDA
Btry	BTRY
btsan	BTSAN
BT's	BT's
BTS	BTS
BTT	BTT
BTU	BTU
btus	BTUS
BTUs	BTU's
BTV	BTV
B.U.	BU
B.U.M.	BUM
BUV	BUV
BVA	BVA
BVB	BVB
BVB's	BVB's
B. V.	BV
B.V.	BV
BVC	BVC
BVFB	BVFB
BVI	BVI
BVM	BVM
BVO	BVO
BVR	BVR
BVRC	BVRC
BVT	BVT
BVVL	BVVL
Bwa	BWA
BWAF	BWAF
B&W	B and W
BWB	BWB
BWBR	BWBR
B. W.	BW
B.W.	BW
B.W.C.	BWC
BWC	BWC
BWF	BWF
BWFC	BWFC
BWHBC	BWHBC
B. W. I.	BWI
BWI	BWI
BWIR	BWIR
BWO	BWO
BWR	BWR
BWS	BWS
BWT	BWT
BWTs	BWT's
BWV	BWV
BWW	BWW
bwwtv	BWWTV
Bxa	BXA
BX	BX
Bxe	BXE
BXML	BXML
BYA's	BYA's
BYB	BYB
B. Y.	BY
byc	BYC
BYC	BYC
BYD	BYD
BYFC	BYFC
BYG	BYG
bygd	BYGD
Byk	BYK
byn	BYN
BYOB	BYOB
Byo	BYO
BYO	BYO
Byou	BYOU
BYR	BYR
Byrl	BYRL
bySLC	BYSLC
BYST	BYST
byt	BYT
B.Y.U.	BYU
BYU	BYU
BYU's	BYU's
BYX	BYX
BYZ	BYZ
B.Z.	BZ
BZ	BZ
BZD	BZD
bzhed	BZHED
Bzik	BZIK
BZK	BZK
BZP	BZP
Bzyb	BZYB
CAA	CAA
CAAC	CAAC
CAAC's	CAAC's
CAAHEP	CAAHEP
CAAM	CAAM
CAAS	CAAS
CAASE	CAASE
Caat	CAAT
CAAT	CAAT
C. A.	CA
C.A.	CA
CA	CA
C&A	C and A
CAC	CAC
CA&CC	CA and CC
CACC	CACC
CACM	CACM
Cadw	CADW
CADW	CADW
caeca	CAECA
Cae	CAE
CAE	CAE
C.A.F.B.	CAFB
CAFTT	CAFTT
C. A. G.	CAG
CAG	CAG
CAGM	CAGM
C. A. I.	CAI
C. A. J.	CAJ
CALUX	CALUX
CAMC	CAMC
CAMLG	CAMLG
C.A.M.'s	CAM's
C. A. N.	CAN
Capt.	captain
C. A. R.	CAR
cas	CAS
Cas	CA's
C.A.S.	CAS
CAS	CAS
Casc	CASC
CASC	CASC
CASD	CASD
CASF	CASF
CASG	CASG
CASQ	CASQ
C. A. T.	CAT
C.A.T.	CAT
CATV	CATV
C.A.W.	CAW
CBA	CBA
CBBB	CBBB
CBB	CBB
CBBC	CBBC
CBBS	CBBS
CBCA	CBCA
cb	CB
C. B.	CB
C.B.	CB
CB	CB
cbc	CBC
CBC	CBC
CB&CNS	CB and CNS
CBC's	CBC's
CBCS	CBCS
CBDA	CBDA
CBD	CBD
CBDs	CBD's
C.B.E.	CBE
CBE	CBE
CBEF	CBEF
CBE's	CBE's
CBF	CBF
CBGB	CBGB
CBGB's	CBGB's
CBGBs	CBGB's
CBG	CBG
CBH	CBH
CBHG	CBHG
CBI	CBI
CBI's	CBI's
CbiXS	CBIXS
CBKB	CBKB
CBK	CBK
CBKMT	CBKMT
CBKRT	CBKRT
CBL	CBL
CBL's	CBL's
CBM	CBM
CBMS	CBMS
CBN	CBN
CBN's	CBN's
CBNT	CBNT
CBO	CBO
CBOT	CBOT
CBP	CBP
CBPE	CBPE
CB&Q	CB and Q
CBR	CBR
CBRE	CBRE
CBRN	CBRN
CBRNE	CBRNE
CBSA	CBSA
CBs	CB's
CBS	CBS
C.B.S.E.	CBSE
CBSE	CBSE
CBS's	CBS's
CBT	CBT
CBTC	CBTC
CBTU	CBTU
CBU	CBU
CBUT	CBUT
CBV	CBV
CBWT	CBWT
CBX	CBX
CBYT	CBYT
CBZH	CBZH
'c	C
CcaA	CCAA
CCAA	CCAA
CCAAT	CCAAT
cca	CCA
Cca	CCA
CCA	CCA
CCAF	CCAF
CCAP	CCAP
CCAR	CCAR
CCAS	CCAS
CCB	CCB
CCBCC	CCBCC
CCBE	CCBE
CCCA	CCCA
C&C	C and C
C. C.	CC
C.C.	CC
CCCE	CCCE
CCCF	CCCF
CCCP	CCCP
CCC's	CCC's
CCDB	CCDB
CCDC	CCDC
ccd	CCD
CCD	CCD
CCDev	CCDEV
CCDI	CCDI
CCDI's	CCDI's
CCDM	CCDM
CCDR	CCDR
CCD's	CCD's
CCDs	CCD's
CCEd	CCED
C.C.E.D.	CCED
CCF	CCF
CCFO	CCFO
CCG	CCG
C.C.G.S.	CCGS
CCGS	CCGS
CCHA	CCHA
CCHC	CCHC
C.C.H.	CCH
CCH	CCH
CCHD	CCHD
CCHS	CCHS
C.C.I.A.A.	CCIAA
CCIAA	CCIAA
CCi	CCI
CCI	CCI
CCID	CCID
CCIE	CCIE
CCIH	CCIH
CCITT	CCITT
CCJ	CCJ
CCK	CCK
CCLC	CCLC
CCL	CCL
CCMA	CCMA
ccm	CCM
CCM	CCM
CCMM	CCMM
CCMP	CCMP
CCMS	CCMS
CCN	CCN
CCNY	CCNY
CCO	CCO
CCOKC	CCOKC
CCOO	CCOO
CCOP	CCOP
C.C.O.W.E. E.T.F.	CCOWEETF
CCP	CCP
CCPD	CCPD
CCPL	CCPL
CCPN	CCPN
CCP's	CCP's
CCQ	CCQ
CCRC	CCRC
CCR	CCR
CCRCs	CCRC's
CCRH	CCRH
CCRS	CCRS
CCSA	CCSA
CCSC	CCSC
CC's	CC's
CCS	CCS
CCSD	CCSD
C.C.S.D.N.Y.	CCSDNY
C.C.S.M.	CCSM
CCSN	CCSN
CCSR	CCSR
CCS's	CCS's
cct	CCT
CCT	CCT
CCTF	CCTF
CCTRN	CCTRN
CCTT	CCTT
CCTV	CCTV
CCUA	CCUA
CCU	CCU
ccus	CCUS
CCV	CCV
CCVG	CCVG
C. C. W.	CCW
CCWD	CCWD
CDA	CDA
CDAT	CDAT
CDB	CDB
CDBS	CDBS
CDCA	CDCA
C&D	C and D
cdc	CDC
CDC	CDC
cd	CD
C. D.	CD
C.D.	CD
CD	CD
CDC's	CDC's
CDDB	CDDB
CD&DR	CD and DR
CDE	CDE
CDF	CDF
CDFI	CDFI
CDFW	CDFW
CDH	CDH
CDi	CDI
CDI	CDI
CDISC	CDISC
CDI's	CDI's
CDK	CDK
CDKN	CDKN
CDL	CDL
CDLI	CDLI
CDLS	CDLS
CDMA	CDMA
CDM	CDM
cDNA	CDNA
cdnas	CDNAS
cDNAs	CDNA's
CDN	CDN
CDN's	CDN's
CDO	CDO
CDOs	CDO's
CDPC	CDPC
CDP	CDP
CDP's	CDP's
CDPs	CDP's
CD&R	CD and R
CDR	CDR
cds	CDS
CD's	CD's
CDs	CD's
CDS	CDS
CDSG	CDSG
CDSP	CDSP
CDSPCo	CDSPCO
CdtA	CDTA
CDT	CDT
CdTe	CDTE
CDTi	CDTI
CDTI	CDTI
CDT's	CDT's
CDTV	CDTV
CDTV's	CDTV's
CDU	CDU
CDU's	CDU's
CD&V	CD and V
CDV	CDV
CDW	CDW
CDWP	CDWP
Cec	CEC
CEC	CEC
c'e	CE
ce	CE
C'e	CE
Ce	CE
C. E.	CE
C.E.	CE
CE	CE
CECP	CECP
CEDA	CEDA
CEDO	CEDO
CEDR	CEDR
CEDS	CEDS
CEEBA	CEEBA
CEEB	CEEB
CEEH	CEEH
Ceel	CEEL
CEEOL	CEEOL
CEESA	CEESA
CEFC	CEFC
CEF	CEF
Cefn	CEFN
CEFP	CEFP
CEFR	CEFR
CEGB	CEGB
C.E.G.	CEG
C. E. H.	CEH
CEI	CEI
C&EI's	C and EI's
C. E. M.	CEM
C&EN	C and EN
cen	CEN
Cen	CEN
CEN	CEN
ceo	CEO
C.E.O.	CEO
CEO	CEO
Ceol	CEOL
CEOP	CEOP
Ceorl	CEORL
Ceos	CEO's
CEO's	CEO's
CEOs'	CEO's
CEOs	CEO's
C.E.P.	CEP
cer	CER
Cer	CER
CER	CER
CERP	CERP
CERPER	CERPER
CERS	CERS
ces	CES
Ces	CE's
C.E.S.	CES
CES	CES
CESL	CESL
CESO	CESO
CETB	CETB
C. E. T.	CET
CEV	CEV
CEVCP	CEVCP
CEVG	CEVG
CEW	CEW
Cex	CEX
CeX	CEX
CEX	CEX
CEZ	CEZ
CEZMS	CEZMS
CFAB	CFAB
Cfa	CFA
CFA	CFA
CFAS	CFAS
C. F. B.	CFB
CFB	CFB
CFBG	CFBG
CFBISD	CFBISD
CFB's	CFB's
C&F	C and F
CFC	CFC
cf	CF
C. F.	CF
C.F.	CF
CF	CF
CFC's	CFC's
CFDA	CFDA
CFD	CFD
C.F.E.	CFE
CFE	CFE
CFFC	CFFC
C. F. F.	CFF
CFF	CFF
C. F. H.	CFH
CFH	CFH
CFHS	CFHS
CFI	CFI
CFIT	CFIT
CFJL	CFJL
CFJR	CFJR
CFL	CFL
CFL's	CFL's
CFM	CFM
CFMEU	CFMEU
CFMI	CFMI
CFND	CFND
CFNY	CFNY
C.F.O.A.	CFOA
CFO	CFO
CFOP	CFOP
CFOs	CFO's
CFPI	CFPI
CFPL	CFPL
CFQ	CFQ
CFRB	CFRB
C.F.R.	CFR
CFR	CFR
CFRP	CFRP
CFS	CFS
CFSCI	CFSCI
CFSP	CFSP
CFTA	CFTA
CFT	CFT
CFTO	CFTO
CFTR	CFTR
CFTs	CFT's
CFTXOP	CFTXOP
CFU	CFU
CFYN	CFYN
CFZ	CFZ
CGA	CGA
CGAP	CGAP
CGB	CGB
C&G	C and G
CGCFAD	CGCFAD
C. G.	CG
C.G.	CG
CGCRI	CGCRI
CGCS	CGCS
CGD	CGD
CGDK	CGDK
CGE	CGE
CGF	CGF
CGFP	CGFP
CGG	CGG
CGI	CGI
CGIL	CGIL
CGKD	CGKD
cgl	CGL
CGL	CGL
CGP	CGP
CGPM	CGPM
CGPME	CGPME
CGPW	CGPW
CGR	CGR
CGRP	CGRP
CGS	CGS
CGSS	CGSS
CGT	CGT
CGTG	CGTG
CGTIC	CGTIC
CGU	CGU
CGW	CGW
CGW's	CGW's
C.H.B.	CHB
CHBM	CHBM
CHBX	CHBX
C&H	C and H
C.H.C.	CHC
C. H.	CH
C.H.	CH
CHCO	CHCO
CHD	CHD
CHDK	CHDK
CHDS	CHDS
CHF	CHF
CHFI	CHFI
C.H.G.	CHG
CHGO	CHGO
CHH	CHH
CHHOTO	CHHOTO
CHHS	CHHS
Chhu	CHHU
Chirs	CHIR's
CHISMS	CHISMS
CHISZ	CHISZ
CHK	CHK
CHL	CHL
CHLR	CHLR
CHL's	CHL's
C. H. M.	CHM
CHM	CHM
CHN	CHN
CHP	CHP
CHP'den	CHPDEN
CHPs	CHP's
CHPS	CHPS
CHR	CHR
CHRDI	CHRDI
CHRGD	CHRGD
C.H.S.	CHS
CHS	CHS
CHSE	CHSE
CHT	CHT
CHV	CHV
CHX	CHX
Chy	CHY
CHYR	CHYR
CIAC	CIAC
Cia	CIA
C.I.A.	CIA
CIA	CIA
CIC	CIC
ci	CI
Ci	CI
C. I.	CI
C.I.	CI
CI	CI
Cicic	CICIC
CICL	CICL
C.I.C.M.	CICM
CICO	CICO
CIC's	CIC's
C.I.D.	CID
CIFF	CIFF
CIFL	CIFL
CIHE	CIHE
CIHR	CIHR
cii	CII
CII	CII
CIID	CIID
CIJ	CIJ
CIKM	CIKM
C.I.L.	CIL
CIL	CIL
cim	CIM
Cim	CIM
CIM	CIM
Cio	CIO
C.I.O.	CIO
CIO	CIO
CIOs	CIO's
CIOT	CIOT
CIPCA	CIPCA
Cip	CIP
C.I.P.	CIP
CIP	CIP
CIPD	CIPD
CIPFA	CIPFA
CIPM	CIPM
CISA	CISA
CISC	CISC
cis	CIS
CIs	CI's
CIS	CIS
CITB	CITB
cit	CIT
CIT	CIT
CiTD	CITD
CITM	CITM
CITN	CITN
CITP	CITP
citS	CITS
CITV	CITV
CITWF	CITWF
CitX	CITX
Ciuc	CIUC
Ciu	CIU
CiU	CIU
CIU	CIU
CIUT	CIUT
CIVD	CIVD
CIW	CIW
CIWS	CIWS
CIX	CIX
Cixi	CIXI
CIY	CIY
CIZN	CIZN
CJA	CJA
CJBHL	CJBHL
CJCA	CJCA
CJCB	CJCB
CJC	CJC
C. J.	CJ
C.J.	CJ
CJD	CJD
C. J. E.	CJE
CJFL	CJFL
CJFT	CJFT
CJFX	CJFX
CJGC	CJGC
CJGO	CJGO
CJHL	CJHL
CJK	CJK
CJL	CJL
CJLS	CJLS
CJM	CJM
CJNT	CJNT
CJOC	CJOC
CJP	CJP
C. J. R.	CJR
C.J.R.	CJR
CJR	CJR
CJSC	CJSC
C. J. S.	CJS
CJS	CJS
CJT	CJT
CJUF	CJUF
CJWC	CJWC
CKAC	CKAC
CKC	CKC
C. K.	CK
C.K.	CK
CK	CK
CKD	CKD
CKE	CKE
CKLM	CKLM
CKLQ	CKLQ
CKLW	CKLW
CKS	CKS
CKSO	CKSO
CKVL	CKVL
C. K. W.	CKW
CKWK	CKWK
ckx	CKX
CKXX	CKXX
CKY	CKY
CLAC	CLAC
CLA	CLA
CLAS	CLAS
CLBs	CLB's
clc	CLC
CLC	CLC
cl	CL
C. L.	CL
C.L.	CL
CL	CL
CLCN	CLCN
CLD	CLD
Cle	CLE
CLE	CLE
CLF	CLF
C.L.G.	CLG
CLG	CLG
CLHIA	CLHIA
CLHS	CLHS
CLI	CLI
CLK	CLK
cllr	CLLR
CLM	CLM
CLMD	CLMD
CLMP	CLMP
CL&N	CL and N
Clo	CLO
CL&P	CL and P
CLP	CLP
CLRC	CLRC
C. L. R.	CLR
C.L.R.	CLR
CLR	CLR
CLRK	CLRK
CLSA	CLSA
CLSC	CLSC
CLs	CL's
CLS	CLS
CLT	CLT
CLTD	CLTD
CLTPA	CLTPA
CLTs	CLT's
Clu	CLU
CLU	CLU
CLUK	CLUK
CLV	CLV
Clwyd	CLWYD
CLX	CLX
C&MA	C and MA
CMAC	CMAC
C.M.A.	CMA
CMA	CMA
CMAL	CMAL
CMAP's	CMAP's
CMAS	CMAS
CMAT	CMAT
C.M.B.	CMB
CMB	CMB
CMCC	CMCC
CMCCDI	CMCCDI
C.M.C.	CMC
CMC	CMC
cm	CM
C. M.	CM
C.M.	CM
CM	CM
CMCs	CMC's
CMCS	CMCS
CMD	CMD
Cmde	CMDE
CMDISE	CMDISE
cmdr	CMDR
CMEC	CMEC
CME	CME
CMF	CMF
CMFS	CMFS
C. M. G.	CMG
C.M.G.	CMG
CMG	CMG
CMHC	CMHC
CMH	CMH
CMHR	CMHR
CMI	CMI
CMJ	CMJ
CMLA	CMLA
cml	CML
C.M.L.	CML
CML	CML
CMLDP	CMLDP
CMLL	CMLL
CMLL's	CMLL's
CMM	CMM
CMMI	CMMI
CMMs	CMM's
cmn	CMN
CMO	CMO
CMO's	CMO's
CMPC	CMPC
CMP	CMP
CMPS	CMPS
CMPSO	CMPSO
CMPV	CMPV
CMQ	CMQ
CMQT	CMQT
C. M. R.	CMR
CMR	CMR
CMSAF	CMSAF
C.M.S.	CMS
CMS	CMS
C.M.S.L.	CMSL
CMT	CMT
Cmte	CMTE
CMT's	CMT's
CMTU	CMTU
CMUCL	CMUCL
CMU	CMU
CMU's	CMU's
CMV	CMV
CMVM	CMVM
CMVSS	CMVSS
CMWF	CMWF
CMXXII	CMXXII
CMYK	CMYK
CNA	CNA
CNBC	CNBC
CNB	CNB
CNC	CNC
cn	CN
C. N.	CN
C.N.	CN
CN	CN
CNC's	CNC's
CND	CND
CNDL	CNDL
CNEB	CNEB
CNE	CNE
CNF	CNF
CNFE	CNFE
CNFK	CNFK
CNG	CNG
CNI	CNI
CNJ	CNJ
CNJF	CNJF
CNK	CNK
C. N. L.	CNL
C.N.L.	CNL
CNL	CNL
CNMs	CNM's
CNN	CNN
CNO	CNO
CNPC	CNPC
CNP	CNP
cnr	CNR
CNR	CNR
CNRMA	CNRMA
CNRS	CNRS
CNSA	CNSA
CNs	CN's
CNS	CNS
CNSS	CNSS
CNSW	CNSW
CNTA	CNTA
CNT	CNT
CNTE	CNTE
CNTI	CNTI
CNTK	CNTK
CNTN	CNTN
CNTs	CNT's
CNTS	CNTS
CNTV	CNTV
CNU	CNU
Cnut's	CNUT's
CNV	CNV
CNVs	CNV's
CNW	CNW
CNWS	CNWS
CNZ	CNZ
COA	COA
C&O	C and O
C. O.	CO
C.O.	CO
Co.	company
C.O.D.	COD
Col.	colonel
C.O.M.L.	COML
CPAC	CPAC
CPA	CPA
CPA's	CPA's
CPB	CPB
CPBL	CPBL
C&P	C and P
CPC	CPC
cp	CP
C. P.	CP
C.P.	CP
CP	CP
CPC's	CPC's
CPCs	CPC's
CPCS	CPCS
CPD	CPD
CPDM	CPDM
CPD's	CPD's
CPEB	CPEB
CPEC	CPEC
C.P.E.	CPE
CPE	CPE
CPEO	CPEO
CPF	CPF
CPFO	CPFO
CPG	CPG
CPHC	CPHC
CPH	CPH
CPI	CPI
CPIFL	CPIFL
CPIM	CPIM
CPI's	CPI's
CPJ	CPJ
CPL	CPL
CPLP	CPLP
CPM	CPM
CPN	CPN
CPNI	CPNI
cpo	CPO
C.P.O.	CPO
CPO	CPO
CPOE	CPOE
CPPA	CPPA
CPPCC	CPPCC
CPP	CPP
CPPE	CPPE
CPPIB	CPPIB
CPPM	CPPM
CPQ	CPQ
CPR	CPR
CPRS	CPRS
CPSA	CPSA
CPSC	CPSC
CPS	CPS
CPSF	CPSF
CPSK	CPSK
CPSL	CPSL
CPSU	CPSU
CPTA	CPTA
CPT	CPT
CPTM	CPTM
CPUC	CPUC
CPU	CPU
CPUID	CPUID
CPUSA	CPUSA
CPUs	CPU's
CPUT	CPUT
CPVA	CPVA
CPV	CPV
CPW	CPW
CQAC	CQAC
CQBR	CQBR
CQC	CQC
cq	CQ
CQ	CQ
CQD	CQD
CQDs	CQD's
CQM	CQM
CQO	CQO
CQU	CQU
C. R. A.	CRA
CRA	CRA
C.R.A.Z.Y.	CRAZY
CRBC	CRBC
CRC	CRC
cr	CR
C. R.	CR
C.R.	CR
CR	CR
Cre	CRE
CRE	CRE
CRF	CRF
CRG	CRG
CRHK	CRHK
CRH's	CRH's
CRHS	CRHS
CRJ	CRJ
crk	CRK
Crkva	CRKVA
crkve	CRKVE
CRL	CRL
CRLs	CRL's
crm	CRM
CRM	CRM
CRNA	CRNA
CRN	CRN
Crne	CRNE
Crni	CRNI
Crno	CRNO
CRP	CRP
CRPF	CRPF
CRRF	CRRF
CRs	CR's
CRS	CRS
CRSP	CRSP
CRST	CRST
CRTC	CRTC
CRT	CRT
CRTC's	CRTC's
CRUA	CRUA
CRWRC	CRWRC
CRW's	CRW's
CRX	CRX
CSAC	CSAC
csa	CSA
Csa	CSA
C.S.A.	CSA
CSA	CSA
CSAH	CSAH
Csak	CSAK
Csaky	CSAKY
CSAR	CSAR
CSAT	CSAT
CSAV	CSAV
CSB	CSB
C&S	C and S
C.S.C.	CSC
CSC	CSC
CSCD	CSCD
CSCE	CSCE
CSCR	CSCR
cs	CS
C.s	C's
Cs	C's
C. S.	CS
C.S.	CS
CS	CS
CSC's	CSC's
CSDA	CSDA
CSDB	CSDB
CSD	CSD
CSDL	CSDL
CSDN	CSDN
CSDP	CSDP
CSD's	CSD's
CSDS	CSDS
CSE	CSE
C&SF	C and SF
CSF	CSF
CSFL	CSFL
CSFSO	CSFSO
CSGA	CSGA
csg	CSG
CSG	CSG
CSG's	CSG's
CSH	CSH
CSHL	CSHL
CSIC	CSIC
CsI	CSI
CSI	CSI
CSIDC	CSIDC
CSILUS	CSILUS
CSIO	CSIO
CSIR	CSIR
CSIRO	CSIRO
CSis	CSI's
CSIs	CSI's
CSIS	CSIS
CSIU	CSIU
CSKA	CSKA
CSKA's	CSKA's
CSK	CSK
CSK's	CSK's
CSL	CSL
CSLI	CSLI
CSM	CSM
CSNB	CSNB
CSNBX	CSNBX
CSN	CSN
CSN's	CSN's
CSOB	CSOB
CSO	CSO
CSO's	CSO's
CSOs	CSO's
cspA	CSPA
csp	CSP
CSP	CSP
CSPH	CSPH
CSPI	CSPI
CSPRA	CSPRA
CSPs	CSP's
CSRA	CSRA
CSR	CSR
CSRS	CSRS
CSRT	CSRT
CSRTT	CSRTT
CSSA	CSSA
CSS	CSS
CSSD	CSSD
CSSE	CSSE
CSSL	CSSL
CSSNCs	CSSNC's
CSSR	CSSR
CSSS	CSSS
CSST	CSST
CSTB	CSTB
CST	CST
CSTF	CSTF
CSTI	CSTI
CSTS	CSTS
CSUB	CSUB
CSU	CSU
CSU's	CSU's
Csuz	CSUZ
CSV	CSV
CSW	CSW
CSWF	CSWF
CSWIP	CSWIP
CSWS	CSWS
CSX	CSX
CSX's	CSX's
CSXT	CSXT
C.T.A.	CTA
CTA	CTA
CTAF	CTAF
CTARL	CTARL
CTA's	CTA's
CTAs	CTA's
CTBT	CTBT
CTBTO	CTBTO
C&T	C and T
CTC	CTC
CTD	CTD
cte	CTE
CTE	CTE
CTEQ	CTEQ
CTF	CTF
CTGF	CTGF
CTI	CTI
CTLA	CTLA
CTL	CTL
CTLLS	CTLLS
CTLs	CTL's
CTM	CTM
CTN	CTN
CTO	CTO
CTP	CTP
ctr	CTR
CTRG	CTRG
Ctrip	CTRIP
CTRL	CTRL
CTRP	CTRP
CTR's	CTR's
CTS	CTS
CTSD	CTSD
CTSF	CTSF
CTSG	CTSG
CTUC	CTUC
CTU	CTU
CTUG	CTUG
CTU's	CTU's
CTVA	CTVA
ctv	CTV
CTV	CTV
CTV's	CTV's
CTX	CTX
CTZ	CTZ
cu	CU
C. U.	CU
CU	CU
C.U.L.	CUL
C. U. S.	CUS
C. U. T.	CUT
CUW	CUW
Cuyp	CUYP
CVA	CVA
CVAK	CVAK
CVARG	CVARG
CVB	CVB
C&V	C and V
CVC	CVC
cvcp	CVCP
'cv	CV
cv	CV
C. V.	CV
C.V.	CV
CV	CV
CVD	CVD
CVEs	CVE's
CVG	CVG
CVI	CVI
CVJM	CVJM
CVM	CVM
C.V.N.	CVN
CVN	CVN
C.V.O.	CVO
CVO	CVO
CVODE	CVODE
CVOs	CVO's
CVP	CVP
CVR	CVR
CVs	CV's
CVS	CVS
CVSNT	CVSNT
CVT	CVT
CVTs	CVT's
CVV	CVV
CVVHDF	CVVHDF
CVW	CVW
CVZ	CVZ
CWA	CWA
CWBI	CWBI
CWBL	CWBL
CWC	CWC
C. W.	CW
C.W.	CW
CWD	CWD
CWDS	CWDS
C. W. E.	CWE
CWE	CWE
Cwej	CWEJ
Cwele	CWELE
CWF	CWF
CWGC	CWGC
CWG	CWG
CWI	CWI
C. W. K.	CWK
cwm	CWM
CWM	CWM
CWO	CWO
CWPA	CWPA
CWR	CWR
cwrt	CWRT
CWRU	CWRU
CWSAC	CWSAC
CW's	CW's
CWS	CWS
CWTS	CWTS
CWUR	CWUR
C. W. Y.	CWY
CWYFL	CWYFL
CXC	CXC
CXCL	CXCL
CXCR	CXCR
C.X.	CX
C. Y.	CY
C.Y.	CY
cyl	CYL
Cyn	CYN
CYOG	CYOG
CyP	CYP
CYP	CYP
Cyrl	CYRL
Cys	CY's
CYS	CYS
CYSK	CYSK
CYSY	CYSY
czci	CZCI
cz	CZ
C.Z.	CZ
CZ	CZ
CZE	CZE
CZM	CZM
CZW	CZW
czy	CZY
DAAD	DAAD
Daai	DAAI
D. A.	DA
D.A.	DA
D&AD	D and AD
D. A. H.	DAH
D.A.M.	DAM
D.A.N.C.E.	dance
D. A. T.	DAT
Dav	DAV
D.A.V.	DAV
DAV	DAV
DAV's	DAV's
dBa	DBA
DBA	DBA
DBC	DBC
DBCS	DBCS
db	DB
D. B.	DB
D.B.	DB
DB	DB
DBE	DBE
DBI	DBI
DBL	DBL
DBLE	DBLE
DBLP	DBLP
DBM	DBM
DBMS	DBMS
DBR	DBR
DB's	DB's
D. B. S.	DBS
DBS	DBS
DBU	DBU
DBYC	DBYC
DBZ	DBZ
DCA	DCA
DCAF	DCAF
DCAM	DCAM
DCB	DCB
DCCC	DCCC
DCCCD	DCCCD
DCC	DCC
DCCG	DCCG
DCCs	DCC's
D&C	D and C
dc	DC
D. C.	DC
D.C.	DC
DC	DC
DCE	DCE
DCFC	DCFC
DCF	DCF
DCG	DCG
DCH	DCH
DCI	DCI
DCK	DCK
D.C.L.	DCL
DCL	DCL
DCMA	DCMA
DCM	DCM
DCMF	DCMF
DCMI	DCMI
DCMS	DCMS
DCO	DCO
DCom	DCOM
DCOM	DCOM
DCP	DCP
DCR	DCR
D.C.'s	DC's
DC's	DC's
DCs	DC's
DCS	DCS
DCSD	DCSD
DCSO	DCSO
DCSPER	DCSPER
DCSS	DCSS
DCTA	DCTA
DCT	DCT
DCU	DCU
DCUO	DCUO
DCUs	DCU's
DDA	DDA
DDB	DDB
D.D.C.	DDC
DDC	DDC
D&D	D and D
D. D.	DD
D.D.	DD
DDF	DDF
DDG	DDG
DDHH	DDHH
DDi	DDI
DDI	DDI
DDK	DDK
DDLJ	DDLJ
DDM	DDM
DDMS	DDMS
DDN	DDN
DDNOS	DDNOS
Ddoc	DDOC
DDO	DDO
DDP	DDP
DDR	DDR
DDRMAX	DDRMAX
DDSB	DDSB
D.D.S.	DDS
DDS	DDS
DDT	DDT
DDTV	DDTV
Ddu	DDU
DDWFTTW	DDWFTTW
DDX	DDX
D.E.A.F.	DEAF
Deah	DEAH
DEA's	DEA's
DECC	DECC
DEC	DEC
DECS	DECS
DEDD	DEDD
D. E.	DE
D.E.	DE
deg	DEG
D. E. G.	DEG
DEG	DEG
DEH	DEH
DEHP	DEHP
dei	DEI
Dei	DEI
DeI	DEI
DEI	DEI
Deijm	DEIJM
Deip	DEIP
D. E. J.	DEJ
D.E.R.	DER
dez	DEZ
Dez	DEZ
Dfa	DFA
DFA	DFA
DFB	DFB
D.F.C.	DFC
DFC	DFC
DFCs	DFC's
D. F.	DF
D.F.	DF
DFD's	DFD's
DfE	DFE
D.F.E.	DFE
DFE	DFE
DfES	DFES
DFF	DFF
DFG	DFG
DFJ	DFJ
DFL	DFL
DFM	DFM
DFOA	DFOA
DFO	DFO
DFP	DFP
DFPs	DFP's
DFRC	DFRC
DFR	DFR
DFs	DF's
DFS	DFS
DFT	DFT
DFW	DFW
dfx	DFX
DFX	DFX
DGAC	DGAC
DGA	DGA
DGALS	DGALS
DGAP	DGAP
DGB	DGB
DGCA	DGCA
DGC	DGC
DGCR	DGCR
D&G	D and G
D. G.	DG
D.G.	DG
D. G. E.	DGE
DGE	DGE
DGERT	DGERT
DGF	DGF
DGFI	DGFI
DGH	DGH
DGK	DGK
D. G. L. R.	DGLR
DGM	DGM
DGMO	DGMO
DGP	DGP
DGPS	DGPS
DGR	DGR
Dha	DHA
DHA	DHA
DHB	DHB
DHBs	DHB's
DHCP	DHCP
D&H	D and H
dh	DH
D. H.	DH
D.H.	DH
DH	DH
DHEA	DHEA
d'HEC	DHEC
dhe	DHE
DHE	DHE
Dheku	DHEKU
DHFS	DHFS
DHHC	DHHC
DHH	DHH
DHL	DHL
DHMO	DHMO
DHNC	DHNC
D.H.N.	DHN
DHNS	DHNS
Dhod	DHOD
dhol	DHOL
Dhol	DHOL
Dhoo	DHOO
Dhor	DHOR
Dhou	DHOU
DHP	DHP
DHPH	DHPH
DHQ	DHQ
dhr	DHR
D.H.R.	DHR
DHRS	DHRS
DHS	DHS
DHSs	DHS's
DHSS	DHSS
DHT	DHT
DHV	DHV
DHW	DHW
DHX	DHX
D.I.	DI
DIFC	DIFC
DISD	DISD
DIW	DIW
DIX	DIX
diy	DIY
DiY	DIY
D.I.Y.	DIY
DIY	DIY
Diyn	DIYN
DIYs	DIY's
D. J. A.	DJA
Djam	DJAM
dj	DJ
D. J.	DJ
D.J.	DJ
DJ	DJ
DJ'ed	DJED
Djem	DJEM
D.J.H.	DJH
Dji	DJI
DJI	DJI
D.J.N.	DJN
Djo	DJO
D'Jok	DJOK
djr	DJR
DJR	DJR
D.J.s	DJ's
DJ's	DJ's
DJs	DJ's
D. J. S.	DJS
D.J.T.	DJT
DjVu	DJVU
DJVU	DJVU
DjVus	DJVU's
D. J. Y.	DJY
DKC	DKC
D. K.	DK
D.K.	DK
DKI	DKI
DKIM	DKIM
DKK	DKK
DKNY	DKNY
DKPP	DKPP
D. K. R.	DKR
DKW	DKW
dla	DLA
DLA	DLA
DLC	DLC
DLD	DLD
dl	DL
D. L.	DL
D.L.	DL
DL	DL
DLE	DLE
D.L.F.	DLF
DLF	DLF
DLFN	DLFN
DLG	DLG
D. L. H.	DLH
dlia	DLIA
DLI	DLI
DLJ	DLJ
DLJ's	DLJ's
DLK	DLK
DLL	DLL
DL&LR	DL and LR
DLL's	DLL's
DLLs	DLL's
DLM	DLM
DLMPST	DLMPST
dlo	DLO
DLP	DLP
DLPFC	DLPFC
DLP's	DLP's
DLR	DLR
DLS	DLS
DLSS	DLSS
DLSU	DLSU
DLSU's	DLSU's
DLT	DLT
DL&W	DL and W
DLZ	DLZ
DMAA	DMAA
DMA	DMA
DMB	DMB
DMBT	DMBT
DMCA	DMCA
DMCC	DMCC
DMC	DMC
DMCM	DMCM
D.M.C.'s	DMC's
D&M	D and M
DMD	DMD
DMDK	DMDK
D. M.	DM
D.M.	DM
DM	DM
DMDS	DMDS
DMed	DMED
DM&E	DM and E
DME	DME
DMF	DMF
DMG	DMG
DMGT	DMGT
DMHS	DMHS
DMI	DMI
DMK	DMK
DML	DML
DMN	DMN
DMO	DMO
DMOFD	DMOFD
DMOZ	DMOZ
DMP	DMP
DMRC	DMRC
DMR	DMR
DMRG	DMRG
DMs	DM's
DMS	DMS
DMSII	DMSII
DMT	DMT
DMTF	DMTF
DMU	DMU
DMUs	DMU's
DMV	DMV
DMX	DMX
DMZ	DMZ
Dna	DNA
DnA	DNA
DNA	DNA
DNADTC	DNADTC
DNAITV	DNAITV
DNAJA	DNAJA
DNAJC	DNAJC
DnaJ	DNAJ
DNAN	DNAN
DNB	DNB
DNBY	DNBY
DNC	DNC
DNCG	DNCG
DND	DND
D. N.	DN
D.N.	DN
Dnepr	DNEPR
dnes	DNES
Dnes	DNE's
DNES	DNES
DNF	DNF
DNF's	DNF's
DNFs	DNF's
DNG	DNG
DNJO	DNJO
DNKA	DNKA
DNK	DNK
DNM	DNM
DNMT	DNMT
DNP	DNP
DNQ	DNQ
DNR	DNR
DNSBLs	DNSBL's
dns	DNS
D.N.S.	DNS
DNS	DNS
DNSS	DNSS
DNT	DNT
DNU	DNU
DNVP	DNVP
D.O.A.	DOA
D.O.A.'s	DOA's
DOAS	DOAS
D.O.B.	DOB
D.O.C.	DOC
DOCG	DOCG
dod	DOD
Dod	DOD
DoD	DOD
DOD	DOD
D. O.	DO
D.O.	DO
DOD's	DOD's
D.O.E.	DOE
DOGNY	DOGNY
DOHC	DOHC
D'oh	DOH
DOJ	DOJ
DOJ's	DOJ's
dok	DOK
Dok	DOK
domt	DOMT
Domt	DOMT
Dop	DOP
DOP	DOP
DOPR	DOPR
DOSAAF	DOSAAF
DOTC	DOTC
dotCMS	DOTCMS
DOTD	DOTD
DOTP	DOTP
DotSVN	DOTSVN
Douw	DOUW
DOW	DOW
DOXO	DOXO
dozd	DOZD
d'OZ	DOZ
Dozhd	DOZHD
DPAA's	DPAA's
DPA	DPA
DPB	DPB
DPD	DPD
dp	DP
D. P.	DP
D.P.	DP
DP	DP
DPG	DPG
DPJ	DPJ
DPMA	DPMA
DPM	DPM
DPN	DPN
DPNM	DPNM
DPO	DPO
dpon	DPON
DPP	DPP
DPP's	DPP's
DPPX	DPPX
DPR	DPR
DPRK	DPRK
DPRK's	DPRK's
DProf	DPROF
DPRP	DPRP
DPRT	DPRT
DPs	DP's
DPS	DPS
DPSS	DPSS
DPSSL	DPSSL
DPT	DPT
DPW	DPW
DPW's	DPW's
DPX	DPX
DPYS	DPYS
D.Q.	DQ
DQOY	DQOY
DQV	DQV
DRB	DRB
DRBG	DRBG
DRB's	DRB's
DRCA	DRCA
drc	DRC
DRC	DRC
DRDA	DRDA
DRDC	DRDC
DRD	DRD
Dr.	doctor
D. R.	DR
D.R.	DR
DRG	DRG
dri	DRI
Dri	DRI
DRI	DRI
DRIs	DRI's
DRITTES	DRITTES
Driu	DRIU
Driv	DRIV
DRJTBC	DRJTBC
DRK	DRK
DRL	DRL
DRLR	DRLR
DRMC	DRMC
D.R.M.	DRM
DRM	DRM
Drnis	DRNI's
Dro	DRO
DRO	DRO
DRP	DRP
Drs.	doctors
DR's	DR's
DRS	DRS
Drska	DRSKA
DRT	DRT
druj	DRUJ
DSA	DSA
DsbA	DSBA
DS&BB	DS and BB
DSB	DSB
DSBL	DSBL
D.S.C.	DSC
DSC	DSC
D.S.C.H.	DSCH
DSCM	DSCM
DSCR	DSCR
DSCS	DSCS
DSDB	DSDB
DSD	DSD
DSDM	DSDM
dsDNA	DSDNA
DSDP	DSDP
ds	DS
Ds	D's
D. S.	DS
D.S.	DS
DS	DS
DSDS	DSDS
DSG	DSG
DSGi	DSGI
DSIC	DSIC
dsi	DSI
DSi	DSI
DSI	DSI
DSIF	DSIF
DSIR	DSIR
DSJ	DSJ
dsl	DSL
D. S. L.	DSL
DSL	DSL
DSLR	DSLR
DSMB	DSMB
D.S.M.	DSM
DSM	DSM
DSMs	DSM's
dsn	DSN
D&SNGRR	D and SNGRR
DSNP	DSNP
D.S.O.	DSO
DSO	DSO
DSPA	DSPA
DSP	DSP
DSR	DSR
DS's	DS's
DSS	DSS
DST	DST
dsu'	DSU
DSU	DSU
DSV	DSV
DSW	DSW
DSX	DSX
DSZG	DSZG
D.T.A.	DTA
DTA	DTA
DTC	DTC
DTC's	DTC's
DTCs	DTC's
DTDC	DTDC
DTD	DTD
DTDs	DTD's
D. T.	DT
D.T.	DT
DT&E	DT and E
DTE	DTE
DTEK	DTEK
DTES	DTES
DTG	DTG
DTH	DTH
DTIC	DTIC
DT&I	DT and I
DTI	DTI
DTLA	DTLA
dtl	DTL
DTL	DTL
DTLLS	DTLLS
DTLS	DTLS
DTM	DTM
DTO	DTO
DTPA	DTPA
DTPC	DTPC
DTRA	DTRA
DTR	DTR
DTRS	DTRS
DTs	DT's
DTS	DTS
DTT	DTT
D.T.U.	DTU
DTU	DTU
DTV	DTV
dty	DTY
D.U.	DU
dva	DVA
Dva	DVA
DVA	DVA
DVB	DVB
DVBE	DVBE
DVBIC	DVBIC
DVC	DVC
DVCs	DVC's
DVCS	DVCS
dvd	DVD
DVD	DVD
DVD's	DVD's
DVDs	DVD's
dv	DV
D. V.	DV
D.V.	DV
DV	DV
dve	DVE
dvfb	DVFB
DVFS	DVFS
DVGS	DVGS
DVHS	DVHS
dvi	DVI
DVI	DVI
dvije	DVIJE
Dvin	DVIN
Dvir	DVIR
DVLA	DVLA
DVLA's	DVLA's
DVL	DVL
DVM	DVM
DVP	DVP
DVR	DVR
DVRJRBC	DVRJRBC
DVR's	DVR's
DVSC	DVSC
DVS	DVS
DVT	DVT
DVV	DVV
DVVT	DVVT
DVWK	DVWK
Dwa	DWA
DWA	DWA
D&W	D and W
D. W.	DW
D.W.	DW
Dwedw	DWEDW
DWET	DWET
DWF	DWF
DWG	DWG
D.W.H.	DWH
Dwi	DWI
DWI	DWI
DWM	DWM
DWN	DWN
DWNU	DWNU
DWP	DWP
dwr	DWR
DWR	DWR
DWRFC	DWRFC
DWS	DWS
DWT	DWT
DWTS	DWTS
dwur	DWUR
dxa	DXA
DXA	DXA
dx	DX
D.X.	DX
DX	DX
DXED	DXED
DXers	DXER's
DXII	DXII
DXK	DXK
DXR	DXR
DXZ	DXZ
Dydd	DYDD
dy	DY
Dy	DY
D. Y.	DY
DY	DY
DYFI	DYFI
DYIS	DYIS
DYNC	DYNC
dypl	DYPL
dyr	DYR
DYSP	DYSP
DZBB	DZBB
DZB	DZB
dz	DZ
DZEC	DZEC
DZEM	DZEM
dzis	DZIS
DZNE	DZNE
Dzog	DZOG
Dzor	DZOR
DZRH	DZRH
DZRH's	DZRH's
DZS	DZS
Dzus	DZU's
DZXL	DZXL
DZZ	DZZ
EAAB	EAAB
EAA	EAA
EAAP	EAAP
E. A. C.	EAC
EAC	EAC
EACEF	EACEF
EACS	EACS
EAD	EAD
E. A.	EA
E.A.	EA
EAF	EAF
EAGE	EAGE
E.A.H.	EAH
EAH	EAH
EAI	EAI
EAIE	EAIE
E. A. J.	EAJ
EAMs	EAM's
EAP	EAP
E.A.R.L.	EARL
E.A.R.T.H.	EARTH
EASA	EASA
EASB	EASB
eas	EAS
Eas	EA's
EA's	EA's
EAS	EAS
Eav	EAV
EAX	EAX
E. B.	EB
E.B.	EB
EBL	EBL
Ebn	EBN
EBNF	EBNF
EBOV	EBOV
E&BR	E and BR
EBR	EBR
Ebru	EBRU
EBS	EBS
EBSL	EBSL
EBT	EBT
EBU	EBU
EBV	EBV
E.B.W.	EBW
EBWs	EBW's
EBZR	EBZR
ECAC	ECAC
ECA	ECA
ECAR	ECAR
ECB	ECB
ECBJ	ECBJ
ECBL	ECBL
ECCA	ECCA
ECCC	ECCC
ecc	ECC
ECC	ECC
ECCI	ECCI
Eccl	ECCL
ECCRFA	ECCRFA
ECCW	ECCW
ECD	ECD
ec	EC
Ec	EC
E. C.	EC
E.C.	EC
EC	EC
ece	ECE
Ece	ECE
ECE	ECE
Ecem	ECEM
ECFA	ECFA
ECF	ECF
ECFR	ECFR
ECFU	ECFU
ecg	ECG
ECG	ECG
ECH	ECH
ECHL	ECHL
ECHR	ECHR
ECI	ECI
ECJ	ECJ
ECLAC	ECLAC
ECLA	ECLA
ECLC	ECLC
ECL	ECL
ECLI	ECLI
ECLSS	ECLSS
ecma	ECMA
ECMA	ECMA
ECMC	ECMC
ECMDB	ECMDB
E.C.M.	ECM
ECM	ECM
ECMI	ECMI
ECML	ECML
ECMLRUS	ECMLRUS
ECMWF	ECMWF
ECN	ECN
ECNP	ECNP
ECNs	ECN's
ECNS	ECNS
ECNZ	ECNZ
ECP&DA's	ECP and DA's
ECP	ECP
ECPR	ECPR
ECQ	ECQ
ECR	ECR
eCRM	ECRM
ECRR	ECRR
ECR's	ECR's
ECSA	ECSA
EC's	EC's
E. C. S.	ECS
E.C.S.	ECS
ECS	ECS
ect	ECT
E. C. T.	ECT
ECT	ECT
ECTLO	ECTLO
ECTN	ECTN
ECTS	ECTS
ECV	ECV
ECVs	ECV's
ECWA	ECWA
ECW	ECW
edb	EDB
EDB	EDB
EDC	EDC
E. D.	ED
E.D.	ED
EDF	EDF
Edh	EDH
EDH	EDH
edhe	EDHE
EDHF	EDHF
EDIB	EDIB
EDI	EDI
EDK	EDK
EDL	EDL
EDMA	EDMA
EDM	EDM
EDMs	EDM's
EDMW	EDMW
Edmx	EDMX
edn	EDN
Edn	EDN
EDN	EDN
EDP	EDP
EDQH	EDQH
E.D.R.	EDR
EDRP	EDRP
EDSA	EDSA
EDSC	EDSC
eds	EDS
Eds	ED's
E. D. S.	EDS
EDS	EDS
EDSP	EDSP
EDTA	EDTA
EDT	EDT
EDVAC	EDVAC
EDWDO	EDWDO
Edw	EDW
EDXRD	EDXRD
EEA	EEA
EEAF	EEAF
EEAS	EEAS
EEBC	EEBC
Eeb	EEB
EEC	EEC
EECS	EECS
E. E.	EE
E.E.	EE
Eef	EEF
EEF	EEF
Eega	EEGA
EEI	EEI
EEI's	EEI's
EEJF	EEJF
EELC	EELC
eene	EENE
EEOC	EEOC
EEPCO	EEPCO
eep	EEP
EEP	EEP
EERC	EERC
EERI	EERI
Ees	EE's
EES	EES
EEST	EEST
EEUU	EEUU
eeuw	EEUW
Eeuw	EEUW
EEZs	EEZ's
EFA	EFA
EFAS	EFAS
EFCC	EFCC
efc	EFC
EFC	EFC
EFCJ	EFCJ
EFD	EFD
ef	EF
Ef	EF
E. F.	EF
E.F.	EF
EF	EF
E. F. J.	EFJ
E. F. K.	EFK
EFL	EFL
EFM	EFM
EFNB	EFNB
EFPA	EFPA
EFP	EFP
EFQUEL	EFQUEL
EFR	EFR
EFRU	EFRU
EFSA	EFSA
eFS	EFS
Efs	EF's
EFSET	EFSET
EFTPOS	EFTPOS
EFUA	EFUA
Efu	EFU
EFV	EFV
EFVR	EFVR
EFVS	EFVS
E. F. W.	EFW
EFX	EFX
EFY	EFY
E. G. A.	EGA
EGA	EGA
Egba	EGBA
EGBA	EGBA
EGBT	EGBT
EGC	EGC
EGD	EGD
EGF	EGF
egfl	EGFL
EGFL	EGFL
e.g.	for  example
e. g.	for  example
EGFR	EGFR
EG&G	EG and G
E. G. H.	EGH
Egi	EGI
EGL	EGL
EGM	EGM
E&GR	E and GR
EGR	EGR
EGREM	EGREM
EGSC	EGSC
EGX	EGX
egy	EGY
EGY	EGY
Egyl	EGYL
EHAAT	EHAAT
EHAs	EHA's
EHC	EHC
EHCI	EHCI
EHD	EHD
E. H.	EH
E.H.	EH
ehf	EHF
EHF	EHF
E. H. M.	EHM
EHP	EHP
EHRC	EHRC
EHR	EHR
EHS	EHS
EHSH	EHSH
Ehttp	EHTTP
EIA	EIA
EIC	EIC
EiCs	EIC's
EIC's	EIC's
E. I.	EI
E.I.	EI
EIES	EIES
eIF	EIF
EIF	EIF
EIFF	EIFF
EIF's	EIF's
EIT	EIT
EITI	EITI
Eitr	EITR
EITs	EIT's
EIU	EIU
E. J. A.	EJA
EJB	EJB
EJBs	EJB's
EJC	EJC
ej	EJ
E. J.	EJ
E.J.	EJ
EJ	EJ
E. J. H.	EJH
E.J.H.	EJH
EJH	EJH
EJHL	EJHL
EJMA	EJMA
E. J. M.	EJM
EJML	EJML
E. J. R.	EJR
E.J.S.	EJS
EJSM	EJSM
EJV	EJV
EKB	EKB
EKBO	EKBO
EKCO's	EKCO's
EKD	EKD
E. K.	EK
E.K.	EK
EKF	EKF
EKG	EKG
eki	EKI
EKIZ	EKIZ
EKL	EKL
EKLR	EKLR
Ekma	EKMA
EKNU	EKNU
Ekow	EKOW
eks	EKS
Eks	EK's
EKS	EKS
E. K. U.	EKU
EKU	EKU
E. L. C.	ELC
E. L.	EL
E.L.	EL
ELH	ELH
ELTs	ELT's
ELUs	ELU's
ELV	ELV
EMA	EMA
EMAS	EMAS
Embd	EMBD
EMB	EMB
eMC	EMC
EMC	EMC
EMD	EMD
EMD's	EMD's
EMDs	EMD's
EMDS	EMDS
Emea	EMEA
EMEA	EMEA
E&M	E and M
E. M.	EM
E.M.	EM
EMF	EMF
Emge	EMGE
EMG	EMG
EMLL	EMLL
E.M.M.	EMM
EMNLP	EMNLP
EMP	EMP
emra	EMRA
EMR	EMR
EMSC	EMSC
E.M.S.	EMS
EMTE	EMTE
EMT	EMT
EMV	EMV
E&NA	E and NA
Enas	ENA's
ENAS	ENAS
EnBW	ENBW
ENC	ENC
EncFS	ENCFS
Encyc	ENCYC
E.N.D.	END
ENEC	ENEC
E. N.	EN
E.N.	EN
Enes	ENE's
engl	ENGL
Engl	ENGL
ENGM	ENGM
Engr	ENGR
Eni	ENI
ENI	ENI
enn	ENN
Enn	ENN
ENP	ENP
ENR	ENR
ens	ENS
Ens	EN's
ENS	ENS
Enso	ENSO
ENSO	ENSO
ENTJs	ENTJ's
ENTP	ENTP
ENTV	ENTV
EOC	EOC
EOC's	EOC's
EoD	EOD
EOD	EOD
E. O.	EO
E.O.	EO
EOFFTV	EOFFTV
EOG	EOG
Eois	EOI's
EOKA	EOKA
eok	EOK
Eole	EOLE
Eol	EOL
EOL	EOL
Eolss	EOLS's
Eom	EOM
EOOW	EOOW
eop	EOP
eoptta	EOPTTA
Eora	EORA
EOR	EOR
Eorl	EORL
Eors	EOR's
EOSHD	EOSHD
EOTC	EOTC
EOTDC	EOTDC
EOU	EOU
E.O.W.	EOW
E&P	E and P
Epe	EPE
E. P. E.	EPE
EPEG	EPEG
ep	EP
Ep	EP
E. P.	EP
E.P.	EP
EP	EP
EPF	EPF
EPFL	EPFL
EPG	EPG
EPHAR	EPHAR
EPHB	EPHB
Eph	EPH
EPH	EPH
Ephs	EPH's
EPIA	EPIA
epi	EPI
Epi	EPI
EPI	EPI
E.P.J.	EPJ
EPL	EPL
EPLF	EPLF
EPM	EPM
EPOC	EPOC
ePO	EPO
EPO	EPO
epos'	EPO's
epos	EPOS
Epos	EPO's
EPRDF	EPRDF
EPR	EPR
EPRI	EPRI
EPRO	EPRO
EPSC	EPSC
E.P.s	EP's
EPT	EPT
EPV	EPV
EPZA	EPZA
EPZ	EPZ
EQAO	EQAO
eq	EQ
Eq	EQ
EQ	EQ
EQG	EQG
EQN	EQN
EQP	EQP
EQS	EQS
EQT	EQT
E.R.A.	ERA
ERAF	ERAF
ERAU	ERAU
ERCB	ERCB
ERC	ERC
ERCES	ERCES
ERCIM	ERCIM
ERCS	ERCS
E. R. D.	ERD
E. R.	ER
E.R.	ER
ERF	ERF
ERH	ERH
ERJs	ERJ's
ERK	ERK
ERP	ERP
ERPM	ERPM
ERPMRP	ERPMRP
ERRC	ERRC
E. R. R.	ERR
E.R.R.	ERR
ERSAR	ERSAR
ERT	ERT
Eru	ERU
ERU	ERU
ERUUF	ERUUF
Eruv	ERUV
Erv	ERV
ERW	ERW
ES3	ES three
Esa	ESA
E.S.A.	ESA
ESA	ESA
Esam	ESAM
Esa's	ESA's
ESA's	ESA's
Esat	ESAT
ESB	ESB
ESC	ESC
ESCHL	ESCHL
ESCs	ESC's
Esd	ESD
ESD	ESD
ESDI	ESDI
E.S.E.	ESE
E. S.	ES
E.S.	ES
ESF	ESF
ESFG	ESFG
E.S.G.	ESG
ESG	ESG
ESGR	ESGR
esi	ESI
ESI	ESI
ESL	ESL
ESM	ESM
ESMLC	ESMLC
ESMT	ESMT
ESNAGI	ESNAGI
ESN	ESN
ESPA	ESPA
ESPC	ESPC
ESPD	ESPD
ESP	ESP
espn	ESPN
ESPN	ESPN
ESPNhttp	ESPNHTTP
ESPN's	ESPN's
ESPNU	ESPNU
ESPNW's	ESPNW's
esq	ESQ
Esq	ESQ
Esq.	esquire
Esraa	ESRAA
Esra	ESRA
ESRB	ESRB
ESRC	ESRC
Esref	ESREF
ESR	ESR
ESRF	ESRF
Esri	ESRI
ESRI	ESRI
ESSR	ESSR
estd	ESTD
Estd	ESTD
EST	EST
ESTP	ESTP
esu	ESU
ESU	ESU
ESU's	ESU's
Esva	ESVA
ESV	ESV
ESWAT	ESWAT
ESW	ESW
Etad	ETAD
ETA	ETA
ETAF	ETAF
ETA's	ETA's
ETASU	ETASU
ETB	ETB
ETBs	ETB's
E.T.C.	ETC
ETCO's	ETCO's
ETCS	ETCS
ETCSL	ETCSL
ETD	ETD
E. T.	ET
E.T.	ET
ETF	ETF
ETFs	ETF's
ETFS	ETFS
Et'hem	ETHEM
ETH	ETH
Eti	ETI
ETI	ETI
ETIM	ETIM
ETIM's	ETIM's
etj	ETJ
ETJ	ETJ
ETL	ETL
ETNZ	ETNZ
Eto	ETO
ETO	ETO
ETRM	ETRM
ETRS	ETRS
ETSEIB	ETSEIB
ets	ETS
Ets	ET's
ET's	ET's
ETs	ET's
ETS	ETS
ett	ETT
Ett	ETT
ETT	ETT
Ettre	ETTRE
Etts	ETT's
ETU	ETU
ETV	ETV
Etz	ETZ
EUA	EUA
EUB	EUB
EUBs	EUB's
EUBS	EUBS
EUCAP	EUCAP
EUCE	EUCE
EUC	EUC
EUCOM's	EUCOM's
EUDEC	EUDEC
EUD	EUD
E. U.	EU
E.U.	EU
EU	EU
eup	EUP
EUP	EUP
Eurwg	EURWG
EUSA	EUSA
Euse	EUSE
EU's	EU's
EUS	EUS
EUSEW	EUSEW
Eusi	EUSI
EUV	EUV
EUX	EUX
EVAAP	EVAAP
EvaGT	EVAGT
EVDC	EVDC
EVD	EVD
EVDO	EVDO
E. V.	EV
E.V.	EV
EVEX	EVEX
EVIT	EVIT
evl	EVL
EVL	EVL
EVM	EVM
Evna	EVNA
EVN	EVN
EVNS	EVNS
evnt	EVNT
E.V.O.	EVO
E.V.O.L.	EVOL
EVP	EVP
EVR	EVR
EVs	EV's
EVS	EVS
evv	EVV
EVV	EVV
Ewa's	EWA's
EWD	EWD
EWEB	EWEB
E. W.	EW
E.W.	EW
EWF	EWF
EWF's	EWF's
Ewha	EWHA
EWH	EWH
E.W.K.	EWK
EWLA	EWLA
EWL	EWL
EWO	EWO
EWOs	EWO's
EWP	EWP
EW's	EW's
EWS	EWS
EWTN	EWTN
Ewu	EWU
EWU	EWU
excl	EXCL
exd	EXD
E.X.	EX
exhb	EXHB
exh	EXH
EXI	EXI
EXIF	EXIF
EXIN	EXIN
EXL	EXL
EXLM	EXLM
E. X. M.	EXM
Exptl	EXPTL
EXR	EXR
exsul	EXSUL
EXT	EXT
EYA	EYA
EYCN	EYCN
EYD	EYD
E&Y	E and Y
E. Y.	EY
EY	EY
Eyk	EYK
eyu	EYU
Ezaa	EZAA
ez	EZ
Ez	EZ
EZ	EZ
Ezh	EZH
EZH	EZH
EZO	EZO
EZR	EZR
EZTV	EZTV
Ezu	EZU
EZW	EZW
Ezy	EZY
Faaa	FAAA
faa	FAA
Faa	FAA
FAA	FAA
faama	FAAMA
FAANP	FAANP
FabH	FABH
FABM	FABM
FabR	FABR
F.A.B.'s	FAB's
F.A.C.E.	FACE
FACR	FACR
F.A.C.S.	FACS
FADD	FADD
Fadl	FADL
FADS	FADS
FAEM	FAEM
fa	FA
Fa	FA
F. A.	FA
F.A.	FA
FA	FA
Faf	FAF
FAFG	FAFG
Fafhrd	FAFHRD
FAFL	FAFL
F. A. G.	FAG
F.A.H.	FAH
fai	FAI
Fai	FAI
FAI	FAI
FAIM	FAIM
FAIP	FAIP
FAIPs	FAIP's
Faiq	FAIQ
fajn	FAJN
FAK	FAK
Fal	FAL
FAL	FAL
F.A.M.E.	FAME
F.A.M.	FAM
FAQ	FAQ
FARC's	FARC's
FARDC	FARDC
F.A.R.	FAR
farw	FARW
FASA	FASA
FASB	FASB
fasc	FASC
Fasc	FASC
fas	FAS
Fas	FA's
FAs	FA's
F.A.S.	FAS
FAS	FAS
FASG	FASG
FasL	FASL
FASRE	FASRE
FATF	FATF
FAUP	FAUP
FAVC	FAVC
FBA	FBA
FBD	FBD
FBFA	FBFA
F. B.	FB
F.B.	FB
FB	FB
F.B.G.s	FBG's
F.B.I.	FBI
FBI	FBI
FBI's	FBI's
FBK	FBK
FBL	FBL
FBMW	FBMW
FBN	FBN
FBO	FBO
FBOs	FBO's
FBPA	FBPA
FBR	FBR
FBS	FBS
FBSN	FBSN
FBSU	FBSU
FBT	FBT
FCA	FCA
fcb	FCB
FCB	FCB
FCBF	FCBF
F.C.B.I.	FCBI
FCBL	FCBL
FCBs	FCB's
F.C.C.	FCC
FCC	FCC
FCD	FCD
F&C	F and C
fc	FC
F. C.	FC
F.C.	FC
FCF	FCF
FCGR	FCGR
F. C. H.	FCH
F.C.H.L.	FCHL
FCIAC	FCIAC
FCIC	FCIC
FCI	FCI
FCIP	FCIP
FCK	FCK
FCL	FCL
FCNM	FCNM
FCNZ	FCNZ
FCO	FCO
FCP	FCP
F.C.P.R.E.M.I.X.	FCPREMIX
FCPS	FCPS
FCRLA	FCRLA
F.C.'s	FC's
FC's	FC's
FCS	FCS
FCT	FCT
FCU	FCU
FCUL	FCUL
FCV	FCV
F. C. W.	FCW
FCW	FCW
FCW's	FCW's
FDA	FDA
FDCC	FDCC
FD&C	FD and C
FDCPA	FDCPA
FDCPAs	FDCPA's
FDD	FDD
FDDI	FDDI
FDE	FDE
F. D.	FD
F.D.	FD
FDFL	FDFL
FDGB	FDGB
FDG	FDG
FDICs	FDIC's
FdI	FDI
FDI	FDI
FDIO	FDIO
FDJ	FDJ
FDL	FDL
FDLT	FDLT
FDM	FDM
FDMNES	FDMNES
FDNY	FDNY
FDP	FDP
FDP's	FDP's
FDR	FDR
FDU	FDU
F. E.	FE
F.E.	FE
FEFK	FEFK
FEFSI	FEFSI
FEFY	FEFY
FEG	FEG
FEGs	FEG's
FEP	FEP
F.E.R.S.	FERS
Fes	FE's
FES	FES
FFA	FFA
FFAK	FFAK
ffc	FFC
FFC	FFC
FFC's	FFC's
FFDO	FFDO
ff	FF
F. F.	FF
F.F.	FF
FF	FF
FFF	FFF
FFG	FFG
FFH	FFH
FFI	FFI
FFK	FFK
FFL	FFL
FFL's	FFL's
FFME	FFME
ffm	FFM
FFOM	FFOM
FFP	FFP
FFPIR	FFPIR
FFR	FFR
FFSA	FFSA
FF's	FF's
FFs	FF's
FFS	FFS
FFU	FFU
FFV	FFV
FFWD	FFWD
FGCU	FGCU
FGFA	FGFA
FGF	FGF
F. G.	FG
F.G.	FG
FGFR	FGFR
FGID	FGID
fgk	FGK
FGL	FGL
FGM	FGM
FGR	FGR
FGs	FG's
FGS	FGS
FGU	FGU
FGV	FGV
F. H. A.	FHA
FHA	FHA
FHAR	FHAR
F. H. C.	FHC
FHFA	FHFA
F. H.	FH
F.H.	FH
FHI's	FHI's
FHL	FHL
fhm	FHM
FHM	FHM
FHM's	FHM's
FHQ	FHQ
FHSAA	FHSAA
FHS	FHS
FHWA	FHWA
F. H. W.	FHW
FIAC	FIAC
fiadh	FIADH
fia	FIA
FIA	FIA
FIAPO	FIAPO
FIA's	FIA's
FIAS	FIAS
FIBCO	FIBCO
F. I. B.	FIB
FiBL	FIBL
FIBT	FIBT
FIC	FIC
Fi'd	FID
FIDH	FIDH
F.I	F
F&I	F and I
F. I.	FI
F.I.	FI
FIFTA	FIFTA
FIGC	FIGC
Figl	FIGL
FIH	FIH
FIH's	FIH's
fija	FIJA
FIJL	FIJL
FIK	FIK
F.I.M.	FIM
FIM	FIM
FIMI	FIMI
Fio	FIO
FiO	FIO
FIO	FIO
F.I.R.	FIR
F.I.T.T.	FITT
FIU	FIU
FIVB	FIVB
F. J. A.	FJA
FJE	FJE
F. J.	FJ
F.J.	FJ
F.J.G.	FJG
FJK	FJK
F. J. M.	FJM
FKA	FKA
FKBP	FKBP
F. K.	FK
F.K.	FK
FKK	FKK
FKL's	FKL's
FKS	FKS
FKY	FKY
Fla	FLA
FLB	FLB
FLCL	FLCL
FLCS	FLCS
FLD	FLD
FLDS	FLDS
FLEC	FLEC
FLE	FLE
Fles	FLE's
FLEST	FLEST
FLETC	FLETC
fl	FL
F. L.	FL
F.L.	FL
FL	FL
FLH	FLH
fli	FLI
FLI	FLI
FLI's	FLI's
FLL	FLL
F.L.M.	FLM
FLM	FLM
FLNB	FLNB
FLN	FLN
FLP	FLP
FLPP	FLPP
FLQ	FLQ
FLRA	FLRA
FLR	FLR
FLRL	FLRL
FLS	FLS
FLSW	FLSW
FLT	FLT
FLTK	FLTK
FLTR	FLTR
FLTS	FLTS
FLV	FLV
FLW	FLW
flyr	FLYR
FMA	FMA
FMARS	FMARS
FMC	FMC
FMCG	FMCG
FMCSA	FMCSA
FMCS	FMCS
FMF	FMF
fm	FM
F. M.	FM
F.M.	FM
FM	FM
FMH	FMH
FMHS	FMHS
FMI	FMI
FMJD	FMJD
FMLN	FMLN
FMM	FMM
FMN	FMN
FMNJ	FMNJ
FMNP	FMNP
FMPA's	FMPA's
FMP	FMP
FMQB	FMQB
FMR	FMR
fMRI	FMRI
FMRP	FMRP
FMRU	FMRU
FM's	FM's
FMs	FM's
FMS	FMS
FMSF's	FMSF's
FMSO	FMSO
FMV	FMV
FMW	FMW
FMX	FMX
FMY	FMY
FNAC	FNAC
F. N. A.	FNA
FNA	FNA
FNB	FNB
FNC	FNC
F. N. D.	FND
FNE	FNE
F. N.	FN
F.N.	FN
FNIC	FNIC
FNI	FNI
FNLA	FNLA
FNLC	FNLC
FNLC's	FNLC's
FNL	FNL
FNO	FNO
FNP	FNP
FNPI	FNPI
FNSEA	FNSEA
FNU	FNUDSA
FOF	FOF
F. O.	FO
FPA	FPA
FPB	FPB
FPC	FPC
FPCP	FPCP
F.P.D.	FPD
FPDs	FPD's
fp	FP
F. P.	FP
F.P.	FP
FP	FP
FPGA	FPGA
FPGAs	FPGA's
FPI	FPI
FPJ	FPJ
FPK	FPK
F. P. L.	FPL
FPL	FPL
FPMR	FPMR
FPM&SA	FPM and SA
FPO	FPO
FPP	FPP
FPPS	FPPS
F.P.R.	FPR
FPR	FPR
FPSC	FPSC
fps	FPS
FPS	FPS
FPSO	FPSO
FPSs	FPS's
FPTP	FPTP
FPU	FPU
FQAD	FQAD
F.Q.	FQ
FRA	FRA
FRA's	FRA's
FRAXA	FRAXA
FRB	FRB
FRBNF	FRBNF
FRCC	FRCC
F. R. C.	FRC
FRC	FRC
FRCNA	FRCNA
FRCP	FRCP
FRCS	FRCS
FRDF	FRDF
F.R.D.	FRD
fr	FR
F. R.	FR
F.R.	FR
FR	FR
FRFS	FRFS
FRFT	FRFT
FRG	FRG
F.R.G.S.	FRGS
F.R.H.S.	FRHS
F.R.I.B.A.	FRIBA
FRMN	FRMN
FRMR	FRMR
FRMS	FRMS
F. R. P.	FRP
FRP	FRP
FRR	FRR
F.R.S.A.	FRSA
FRSA	FRSA
FRSC	FRSC
FRSE	FRSE
frs	FRS
F. R. S.	FRS
F.R.S.	FRS
FRS	FRS
FRSL	FRSL
Fru	FRU
FRU	FRU
FRV	FRV
FRWT	FRWT
Frwydr	FRWYDR
FSA	FSA
FSB	FSB
FSC	FSC
FSCS	FSCS
FSE	FSE
fsf	FSF
FSF	FSF
FSFH	FSFH
FSFLA	FSFLA
fs	FS
F. s	F's
Fs	F's
F. S.	FS
F.S.	FS
FS	FS
FSFS	FSFS
FSG	FSG
FSGS	FSGS
FSH	FSH
FSIC	FSIC
FSI	FSI
FSIL	FSIL
FSK	FSK
FSKN	FSKN
FSLF	FSLF
FSL	FSL
FSLN	FSLN
FSM	FSM
FSM's	FSM's
fsn	FSN
FSN	FSN
FSO	FSO
FSP	FSP
FSPS	FSPS
FSR	FSR
FSRU	FSRU
FSSB	FSSB
FSS	FSS
FSSM	FSSM
FSSRU	FSSRU
FSSs	FSS's
FST	FST
FSU	FSU
FSU's	FSU's
FSV	FSV
FTA	FTA
FTAs	FTA's
F.T.B.	FTB
FTC	FTC
FTD	FTD
FTDI	FTDI
FTE	FTE
FTF	FTF
Ft.	Fort
F. T.	FT
F.T.	FT
FTI	FTI
FTII	FTII
FTJ	FTJ
FTK	FTK
FTL	FTL
FTM	FTM
FTN	FTN
FTO	FTO
ftp	FTP
FTP	FTP
FTPI	FTPI
FTPL	FTPL
FTRA	FTRA
FTR	FTR
FtsA	FTSA
FT's	FT's
FTS	FTS
FTT	FTT
FTTH	FTTH
FTUC	FTUC
Ftuh	FTUH
FTU's	FTU's
FTV	FTV
F. V. B.	FVB
F. V.	FV
F.V.	FV
FVGM	FVGM
FVHS	FVHS
FVJC	FVJC
FVL	FVL
FVP	FVP
FVW	FVW
FVWM	FVWM
FWAA	FWAA
FWA	FWA
FWCD	FWCD
FWD	FWD
FWE	FWE
F&W	F and W
F. W.	FW
F.W.	FW
FWH	FWH
FWI	FWI
FWMW	FWMW
FWO	FWO
fwr	FWR
F.W.R.	FWR
F. W. S.	FWS
F.W.S.	FWS
FWS	FWS
FWX	FWX
FXCM's	FXCM's
FXE	FXE
FXFL	FXFL
fx	FX
FX	FX
FXI	FXI
F.X.R.	FXR
FX's	FX's
FXS	FXS
FXX	FXX
FXX's	FXX's
FXXT	FXXT
Fyb	FYB
FYCO	FYCO
F.Y.	FY
F.Y.I.	FYI
FYI	FYI
Fyn	FYN
FYN	FYN
FYP	FYP
fyr	FYR
F.Y.R.	FYR
FYR	FYR
FYT	FYT
FYU	FYU
Fyw	FYW
FZCI	FZCI
FZD	FZD
F.Z.	FZ
FZG	FZG
FZJD	FZJD
FZKA	FZKA
Gaac	GAAC
GAAF	GAAF
G.A.A.	GAA
G. A.	GA
G.A.	GA
G.A.R.	GAR
GASL	GASL
GATA	GATA
GATV	GATV
GATX	GATX
G. A. W.	GAW
GBA	GBA
GBAG	GBAG
GBASE	GBASE
GBA's	GBA's
GBB	GBB
GBBI	GBBI
GBCA	GBCA
GBC	GBC
GBCM	GBCM
GBD	GBD
Gbe	GBE
GbE	GBE
GBE	GBE
G. B.	GB
G.B.	GB
GBGC	GBGC
GBGM	GBGM
GBH	GBH
GBIB	GBIB
GBIF	GBIF
GBI	GBI
GBK	GBK
GBL	GBL
GBMA	GBMA
G. B. M.	GBM
GB&NDR	GB and NDR
GBP	GBP
GBR	GBR
GB's	GB's
GBS	GBS
GBV	GBV
GBX	GBX
GBYLA	GBYLA
GCAC	GCAC
GCAF	GCAF
GCA	GCA
G. C. B.	GCB
GCB	GCB
GCC	GCC
GCCN	GCCN
GCC's	GCC's
GCCS	GCCS
GCD	GCD
G.C.E.	GCE
GCEP	GCEP
GCF	GCF
G&C	G and C
G. C.	GC
G.C.	GC
GCHQ	GCHQ
GCI	GCI
GCIP	GCIP
GCIT's	GCIT's
GCIV	GCIV
GCJ	GCJ
GCL	GCL
GCMC	GCMC
G.C.M.	GCM
GCM	GCM
GCMG	GCMG
GCN	GCN
GCNT	GCNT
GCOEC	GCOEC
GCOS	GCOS
GCPD	GCPD
GCPH	GCPH
GCR	GCR
GCRIO	GCRIO
GCSE	GCSE
GCSEs	GCSE's
GC&SF	GC and SF
GCS	GCS
GCSI	GCSI
GCU	GCU
GCV	GCV
GCVO	GCVO
GCVS	GCVS
GDA	GDA
Gdal	GDAL
GDAL	GDAL
GDAP	GDAP
GDB	GDB
GDC	GDC
GDD	GDD
GDDM	GDDM
GDDR	GDDR
Gde	GDE
G. D. F.	GDF
GDF	GDF
gd	GD
G. D.	GD
G.D.	GD
GD	GD
GDI	GDI
G.D.L.	GDL
GDN	GDN
G.D.O.D.	GDOD
Gdow	GDOW
G.D.P.	GDP
GDP	GDP
GDPs	GDP's
gdr	GDR
GDR	GDR
GDR's	GDR's
GDS	GDS
GDST	GDST
GDT	GDT
GDV	GDV
Gebr	GEBR
Gebt	GEBT
GEC	GEC
Ged	GED
GED	GED
GEF	GEF
GEGB	GEGB
ge	GE
G. E.	GE
G.E.	GE
GE	GE
GEHA	GEHA
GEHX	GEHX
Gek	GEK
G.E.M.	GEM
Gen.	general
G.E.O.	GEO
G. E. P.	GEP
geq	GEQ
Geu	GEU
GEU	GEU
Gev	GEV
GeV	GEV
GEV	GEV
Gfa	GFA
GFA	GFA
GF&A	GF and A
GFC	GFC
GFD	GFD
GFDL	GFDL
GFE	GFE
GFF	GFF
G. F.	GF
G.F.	GF
GFM	GFM
GFP	GFP
G. F. R.	GFR
GFR	GFR
GFS	GFS
GFSN	GFSN
GFSR	GFSR
GFT	GFT
GFWC	GFWC
GFW	GFW
GFY	GFY
G. G.	GG
G.G.	GG
G. G. J.	GGJ
GGL	GGL
GGM	GGM
GGMRC	GGMRC
GGS	GGS
G.H.A.	GHA
GHB	GHB
GHC	GHC
GHD	GHD
Ghe	GHE
G. H.	GH
G.H.	GH
GHGs	GHG's
Ghir	GHIR
GHK	GHK
GHMC	GHMC
G.H.N.	GHN
G.H.Q.	GHQ
GHQ	GHQ
ghra	GHRA
GHR	GHR
GH&SA	GH and SA
GHSA	GHSA
GHSFHA	GHSFHA
GHS	GHS
GHSR	GHSR
GHSU	GHSU
GHU	GHU
G.H.W.	GHW
GICL	GICL
Giei	GIEI
GIFV	GIFV
G. I.	GI
G.I.	GI
G.J.B.	GJB
G. J.	GJ
G.J.	GJ
G. K.	GK
G.K.	GK
Gla	GLA
GLA	GLA
GLB	GLB
GLBT	GLBT
GLBTQ	GLBTQ
GLC	GLC
G&L	G and L
G. L.	GL
G.L.	GL
gli	GLI
Gli	GLI
GLI	GLI
Glis	GLI's
GLK	GLK
GLL	GLL
GLLI	GLLI
GLM	GLM
glnA	GLNA
G.L.O.R.Y.	GLORY
Glos	GLO's
GLRS	GLRS
GLS	GLS
GLT	GLT
GLVC	GLVC
GLX	GLX
GMAC	GMAC
gma	GMA
GMA	GMA
GMAM	GMAM
GMA's	GMA's
GMAT	GMAT
GMB	GMB
GmbH	GMBH
GMBH	GMBH
GMB's	GMB's
GMCC	GMCC
GMC	GMC
GMCL	GMCL
GMC's	GMC's
GMDSS	GMDSS
GME	GME
Gmel	GMEL
GMES	GMES
GMFF	GMFF
GMF	GMF
GMG	GMG
gm	GM
G. M.	GM
G.M.	GM
GM	GM
GMG's	GMG's
gmin	GMIN
GMM	GMM
GMO	GMO
GMOs	GMO's
GMPC	GMPC
GMPE	GMPE
GMP	GMP
GMPTE	GMPTE
GMR	GMR
GMRL	GMRL
GM's	GM's
GMs	GM's
GMS	GMS
gmt	GMT
GMT	GMT
GMTV	GMTV
Gmul	GMUL
GNAA	GNAA
GNA	GNA
gnb	GNB
GNB	GNB
GNCC	GNCC
G. N. C.	GNC
GNC	GNC
G. N.	GN
G.N.	GN
GNL	GNL
GNP&BR	GNP and BR
GNPDA	GNPDA
gnp	GNP
GNP	GNP
GNPs	GNP's
GNRD	GNRD
GNR	GNR
GNR's	GNR's
GNS	GNS
GNSS	GNSS
GNT	GNT
G.O.	GO
G.O.O.D.	GOOD
GOPB	GOPB
G.O.P.	GOP
GOP	GOP
GOPIO	GOPIO
GOP's	GOP's
GOQ	GOQ
GPA	GPA
GPB	GPB
G.P.C.	GPC
GPC	GPC
GPCR	GPCR
GPCRs	GPCR's
GPD	GPD
GPdI	GPDI
GPDSC	GPDSC
GPF	GPF
GPFS	GPFS
G&P	G and P
GPG	GPG
gp	GP
G. P.	GP
G.P.	GP
GP	GP
GPGPU	GPGPU
GPI	GPI
GpIIb	GPIIB
GPIO	GPIO
GPL	GPL
GPMGs	GPMG's
G.P.O.	GPO
GPO	GPO
GPP	GPP
GPRA	GPRA
GPRF	GPRF
GPR	GPR
GPRs	GPR's
GPRS	GPRS
GPSC	GPSC
GPS	GPS
GPT	GPT
GPU	GPU
GPUs	GPU's
GPX	GPX
G. Q.	GQ
GQ	GQ
GQNYGK	GQNYGK
GQ's	GQ's
GQT's	GQT's
G.R.A.B.	GRAB
grac	GRAC
gra	GRA
Gra	GRA
GRA	GRA
Grbac	GRBAC
GRB	GRB
GRBs	GRB's
grc	GRC
GRC	GRC
GRCs	GRC's
GRDA	GRDA
GRDC	GRDC
G.R.D.	GRD
GRD	GRD
gre	GRE
Gre	GRE
GRE	GRE
GRF	GRF
GRG	GRG
gr	GR
G. R.	GR
G.R.	GR
GR	GR
GRK	GRK
G.R.L.	GRL
GRL	GRL
GRMG	GRMG
GRM	GRM
GRO	GRO
GRP	GRP
grrl	GRRL
G. R. S.	GRS
GRS	GRS
GRT	GRT
GRU	GRU
GRX	GRX
Gryf	GRYF
gry	GRY
Gry	GRY
GRY	GRY
grz	GRZ
GSA	GSA
GSAPP	GSAPP
GSAS	GSAS
GSB	GSB
GSC	GSC
GSDF	GSDF
GSD	GSD
G.S.E.	GSE
GSE	GSE
GSFC	GSFC
GSF	GSF
G&S	G and S
GSG	GSG
Gs	G's
G. S.	GS
G.S.	GS
GS	GS
GSHD	GSHD
GSH	GSH
GSI	GSI
GSIs	GSI's
GSIS	GSIS
GSK	GSK
GSL	GSL
GSLV	GSLV
GSMA	GSMA
GSM	GSM
GSNAS	GSNAS
G. S. N.	GSN
GSN	GSN
GSNM	GSNM
GSN's	GSN's
GSO	GSO
GSOM's	GSOM's
GSOp	GSOP
GSPC	GSPC
G. S. P.	GSP
GSP	GSP
GSR	GSR
GSSE	GSSE
GSS	GSS
GSSP	GSSP
GSTA	GSTA
G.S.T.	GST
GST	GST
GSU	GSU
GSUSA	GSUSA
GSVD	GSVD
GSVS	GSVS
GSX	GSX
GTAA	GTAA
GTA	GTA
GTAs	GTA's
GTB	GTB
GTBK	GTBK
GTBP	GTBP
GTC	GTC
GTCR	GTCR
GTD	GTD
GTEC	GTEC
GTE	GTE
GTF	GTF
GTFT	GTFT
GTFU	GTFU
gt	GT
G. T.	GT
G.T.	GT
GT	GT
G. T. H.	GTH
GTi	GTI
GTI	GTI
GTK	GTK
GTL	GTL
GTMO	GTMO
G. T. O.	GTO
GTO	GTO
GTPBP	GTPBP
GTP	GTP
GTPR	GTPR
GTRA	GTRA
GTR	GTR
GTRI	GTRI
GTs	GT's
GTS	GTS
GTSV	GTSV
GTT	GTT
GTTP	GTTP
GTU	GTU
GTV	GTV
GTW	GTW
GTW's	GTW's
GTX	GTX
G. U.	GU
G.U.	GU
GUI's	GUI's
GUIs	GUI's
G.U.Y.	GUY
GVA	GVA
GVAV	GVAV
GVBA	GVBA
GVC	GVC
G. V.	GV
G.V.	GV
GVHSS	GVHSS
GVJZ	GVJZ
GVK	GVK
GvpA	GVPA
GVP	GVP
GVRD	GVRD
GVSU	GVSU
GVT	GVT
GVU	GVU
GVVV	GVVV
GVW	GVW
GVWR	GVWR
GWA	GWA
GWB	GWB
G. W. C.	GWC
GWe	GWE
Gwet	GWET
G.W.F.	GWF
GWF	GWF
gw	GW
G. W.	GW
G.W.	GW
GW	GW
G. W. H.	GWH
GWHS	GWHS
Gwi	GWI
GWK	GWK
G.W.L.	GWL
GWO	GWO
GWOT	GWOT
gwr	GWR
GWR	GWR
GWR's	GWR's
GW's	GW's
G. W. S.	GWS
GWS	GWS
GWU	GWU
GXG	GXG
GX	GX
GXP	GXP
GYAN's	GYAN's
GYC	GYC
GYF	GYF
Gy	GY
G. Y.	GY
GY	GY
Gyn	GYN
GYN	GYN
Gyps	GYP's
gyu	GYU
Gyu	GYU
GZA	GZA
GZ	GZ
GZR	GZR
HAFV	HAFV
H. A.	HA
H.A.	HA
H&A	H and A
HBA	HBA
HBA's	HBA's
HBBO	HBBO
HBC	HBC
HBCo	HBCO
HBC's	HBC's
HBCU	HBCU
HBES	HBES
HBF	HBF
HBGAs	HBGA's
H. B.	HB
H.B.	HB
HB	HB
HBI	HBI
HBK	HBK
HBLX	HBLX
HBMP	HBMP
HBO	HBO
HBO's	HBO's
HBPU	HBPU
H&BR	H and BR
HBR	HBR
HBRN	HBRN
HBRY	HBRY
HB's	HB's
HBS	HBS
HBSS	HBSS
HBU's	HBU's
HBV	HBV
HBW	HBW
HCA	HCA
HCAW	HCAW
HCBE	HCBE
HCB	HCB
HCBS	HCBS
HCCA	HCCA
HCCB	HCCB
HCCC	HCCC
HCC	HCC
HCDCH	HCDCH
HCE	HCE
HCEs	HCE's
HCF	HCF
H. C. G.	HCG
HCGVN	HCGVN
H. C.	HC
H.C.	HC
HC	HC
HCH	HCH
HCHS	HCHS
HCI	HCI
HCJB	HCJB
hcl	HCL
HCL	HCL
HClO	HCLO
HCMC's	HCMC's
HCME	HCME
HCM	HCM
HCN	HCN
HCO	HCO
HCoV	HCOV
HCPA	HCPA
H. C. P.	HCP
HCP	HCP
HCPs	HCP's
HCR	HCR
HCS	HCS
HCT	HCT
HCTV's	HCTV's
HCUP	HCUP
HCV	HCV
Hcy	HCY
HDAC	HDAC
Hdad	HDAD
hDAF	HDAF
HDA	HDA
HDB	HDB
HDCAM	HDCAM
HDC	HDC
HDCP	HDCP
HDD	HDD
HDDs	HDD's
HDFC	HDFC
H.D.F.	HDF
HDFM	HDFM
H.D.G.	HDG
HDG	HDG
hd	HD
H. D.	HD
H.D.	HD
HD	HD
hdh	HDH
HDi	HDI
HDI	HDI
HDLC	HDLC
HDL	HDL
HDLS	HDLS
HDM	HDM
HDMI	HDMI
HDPE	HDPE
HDP	HDP
HDR	HDR
HDRO	HDRO
HDRR	HDRR
H. E.	HE
H.E.	HE
hezb	HEZB
Hezb	HEZB
HFA	HFA
HFB	HFB
HFC	HFC
HFCS	HFCS
HFDF	HFDF
HFF	HFF
HFF's	HFF's
H&F	H and F
H. F.	HF
H.F.	HF
HFI	HFI
H. F. J.	HFJ
HFNB	HFNB
HFPA	HFPA
HFP	HFP
HFPPV	HFPPV
HFRS	HFRS
HFS	HFS
HFTP	HFTP
H.G.B.	HGB
hgcA	HGCA
HGC	HGC
HGF	HGF
hg	HG
H. G.	HG
H.G.	HG
HG	HG
HGH	HGH
HGNC	HGNC
HgO	HGO
H. G. O.	HGO
HGPIN	HGPIN
HGPs	HGP's
HGTV	HGTV
HGTV's	HGTV's
HgU	HGU
HGVs	HGV's
HGY	HGY
HHA	HHA
H. H. B.	HHB
HHC	HHC
HHD	HHD
HHDP	HHDP
HHG	HHG
H&H	H and H
HHHDB	HHHDB
H. H.	HH
H.H.	HH
HHPC	HHPC
HHSAA	HHSAA
HHS	HHS
H.H.T.	HHT
H. I.	HI
H.I.	HI
H.I.V.E.	HIVE
HIV	HIV
HIY	HIY
Hizb	HIZB
hja	HJA
HJC	HJC
H. J.	HJ
H.J.	HJ
HJ	HJ
HJK	HJK
H.J.M.	HJM
HJN	HJN
H. J. R.	HJR
H.J.R.	HJR
H. J. W.	HJW
HJW	HJW
HKAA	HKAA
Hkam	HKAM
HKB	HKB
HKCEC	HKCEC
HKCEE	HKCEE
HKDF	HKDF
HKD	HKD
HKDSE	HKDSE
HKFC	HKFC
H&K	H and K
H. K.	HK
H.K.	HK
HK	HK
H. K. J.	HKJ
HKK	HKK
HKMA	HKMA
HKN	HKN
H.K.P.	HKP
HKP	HKP
HKSAR	HKSAR
HK's	HK's
HKT	HKT
HKTWU	HKTWU
HKU	HKU
Hla	HLA
HLA	HLA
HLBN	HLBN
HLE	HLE
HLH	HLH
H. L.	HL
H.L.	HL
HLL	HLL
HLLS	HLLS
HLN	HLN
HLN's	HLN's
HLS	HLS
HLT	HLT
HLTV	HLTV
Hluk	HLUK
hlutr	HLUTR
HLV	HLV
Hly	HLY
HMAC	HMAC
HMA	HMA
Hman	HMAN
H.M.A.S.	HMAS
HMAS	HMAS
HMB	HMB
HMC	HMC
HMCS	HMCS
HMDA	HMDA
HMD	HMD
HMDI	HMDI
HMDP	HMDP
HME	HME
HMEL	HMEL
HMF	HMF
HMGA	HMGA
HMG	HMG
HMGIC	HMGIC
HMGN	HMGN
H&M	H and M
HMH	HMH
hm	HM
H. M.	HM
H.M.	HM
HM	HM
HMI	HMI
HMIS	HMIS
HMMC	HMMC
HMM	HMM
HMMWV	HMMWV
HMN	HMN
HMNZS	HMNZS
HMNZT	HMNZT
HMO	HMO
HMOs	HMO's
HMPC	HMPC
HMP	HMP
HMRC	HMRC
hMRE	HMRE
H&M's	H and M's
H. M. S.	HMS
H.M.S.	HMS
HMS	HMS
HMSN	HMSN
H.M.S.O.	HMSO
HMSO	HMSO
H. N.	HN
H.N.	HN
HNI	HNI
HNK	HNK
HNL	HNL
HNLMS	HNLMS
HNMT	HNMT
HNN	HNN
HNO	HNO
HNS	HNS
H. O.	HO
H.O.	HO
HPA	HPA
H.P.B.	HPB
hpc	HPC
HPC	HPC
HPCT	HPCT
H. P. D.	HPD
HPD	HPD
HPE	HPE
HPH	HPH
hp	HP
H. P.	HP
H.P.	HP
HP	HP
HPI	HPI
HPLC	HPLC
HPL	HPL
HPP	HPP
HPRA	HPRA
HPR	HPR
HPRT	HPRT
HP's	HP's
HPS	HPS
H. P. T.	HPT
HPV	HPV
HQAA	HQAA
HQDA	HQDA
H.Q.	HQ
HQ	HQ
HRG	HRG
H&R	H and R
H.R.H.	HRH
HRH	HRH
H. R.	HR
H.R.	HR
HR	HR
HRK	HRK
HRL	HRL
HRM	HRM
hroa	HROA
HRo	HRO
HRO	HRO
HRP	HRP
HRSA	HRSA
HRSA's	HRSA's
HRSG	HRSG
hrs	HRS
HRs	HR's
HRST	HRST
HRT	HRT
HRV	HRV
HRW	HRW
HRX	HRX
HSA	HSA
HSAN	HSAN
HSBC	HSBC
HSB	HSB
HSCA	HSCA
HSC	HSC
hscy	HSCY
HSD	HSD
HSDPA	HSDPA
Hsee	HSEE
HSE	HSE
HSE's	HSE's
HSF	HSF
HSG	HSG
HSHB	HSHB
H.S.H.	HSH
hs	HS
Hs	H's
H. S.	HS
H.S.	HS
HS	HS
HSHS	HSHS
hsi	HSI
HSJ	HSJ
HSK	HSK
HSL	HSL
hSlo	HSLO
H.S.M.	HSM
HSM	HSM
HSMR	HSMR
HSN	HSN
HSNY's	HSNY's
HSPA	HSPA
HSPA's	HSPA's
HSPG	HSPG
HSPH	HSPH
HSP	HSP
HSP's	HSP's
HSPs	HSP's
HSRC	HSRC
HSR	HSR
HSSCCT	HSSCCT
HSSF	HSSF
HSS	HSS
HST	HST
HST's	HST's
HSTs	HST's
HSTS	HSTS
hsv	HSV
HSV	HSV
HSX	HSX
HSY	HSY
HSYK's	HSYK's
HSZ	HSZ
HTA	HTA
hTAS	HTAS
HTAs	HTA's
htc	HTC
HTC	HTC
HTC's	HTC's
HTGL	HTGL
HTHC	HTHC
ht	HT
H. T.	HT
H.T.	HT
HT	HT
HTIB	HTIB
hti	HTI
Htin	HTIN
HTK	HTK
HTLA	HTLA
HTLV	HTLV
HTML	HTML
HTM's	HTM's
Htoo	HTOO
HTPB	HTPB
HTPC	HTPC
HTP	HTP
HtrA	HTRA
HTR	HTR
HTRs	HTR's
HTS	HTS
http	HTTP
HTTP	HTTP
https	HTTPS
HTTPS	HTTPS
HTV	HTV
HTV's	HTV's
Htwa	HTWA
HTW	HTW
HTX	HTX
H. U.	HU
HVC	HVC
HVCs	HVC's
hvcv	HVCV
HVDC	HVDC
hvem	HVEM
Hvem	HVEM
HVF	HVF
HVHS	HVHS
H. V.	HV
H.V.	HV
H.W.A.	HWA
H. W. F.	HWF
H. W.	HW
H.W.	HW
H.W.L.	HWL
HWL	HWL
HWM	HWM
HWRT	HWRT
HWT	HWT
HWV	HWV
hwy	HWY
Hwy	HWY
hxt	HXT
H. Y.	HY
H.Y.	HY
H. Z.	HZ
HZ&PC	HZ and PC
iaaf	IAAF
IAAF	IAAF
IAAF's	IAAF's
IAA	IAA
IAAPA	IAAPA
IAAP	IAAP
IaaS	IAAS
IAAS	IAAS
IABSE	IABSE
Iaca	IACA
IACC	IACC
IACD	IACD
IAC	IAC
Iacob	IACOB
IACR	IACR
IAC's	IAC's
IACTs	IACT's
Iacub	IACUB
IACUC	IACUC
IACW	IACW
IAD	IAD
IAD's	IAD's
IAEA	IAEA
IAEG	IAEG
I.A.E.	IAE
IAE	IAE
IAF	IAF
IAF's	IAF's
IAG	IAG
IAG's	IAG's
iagt	IAGT
IAHP	IAHP
IAHRC	IAHRC
I. A.	IA
I.A.	IA
I.A.M.	IAM
IAO	IAO
Iapa	IAPA
IAPHC	IAPHC
IAP	IAP
iar	IAR
Iar	IAR
IAR	IAR
IAST	IAST
IATA	IATA
I.A.T.	IAT
IAT	IAT
IATR	IATR
IAUC	IAUC
IAUCs	IAUC's
IAU	IAU
IAV	IAV
IAWTV	IAWTV
Iax	IAX
IAX	IAX
Ibac	IBAC
Ibaes	IBAE's
IBA's	IBA's
IBB	IBB
IBC	IBC
IBCs	IBC's
IBCT	IBCT
IBDA'A	IBDAA
Ibda	IBDA
ibdal	IBDAL
IBDB	IBDB
IBDE	IBDE
IBD	IBD
IBE	IBE
IBF	IBF
IBGE	IBGE
IBH	IBH
I. B.	IB
I.B.	IB
IBJJF	IBJJF
IBL	IBL
IBLT	IBLT
IBMA's	IBMA's
IBMC	IBMC
Ibm	IBM
I.B.M.	IBM
IBM	IBM
IBM's	IBM's
IBMXF	IBMXF
Ibne	IBNE
ibn	IBN
IBO	IBO
IBPA	IBPA
IBP	IBP
Ibra	IBRA
IBRA	IBRA
IBRC	IBRC
IBR	IBR
IBRO	IBRO
Ibsa	IBSA
IBSA	IBSA
IBSF	IBSF
Ibs	IB's
IBS	IBS
IBSL	IBSL
IBTC	IBTC
iBT	IBT
IBTS	IBTS
Ibu	IBU
IBU	IBU
IBV	IBV
IBWFF	IBWFF
iby	IBY
ICBA	ICBA
ICBC	ICBC
ICB	ICB
ICBL	ICBL
ICBM	ICBM
ICBMs	ICBM's
ICBP	ICBP
ICBS	ICBS
ICBTT	ICBTT
ICCC	ICCC
ICCC's	ICCC's
ICCEC	ICCEC
ICCF	ICCF
Icche	ICCHE
I.C.C.	ICC
ICC	ICC
ICCID	ICCID
ICCI	ICCI
ICCR	ICCR
ICC's	ICC's
ICCS	ICCS
ICCW	ICCW
ICDC	ICDC
ICD	ICD
ICDS	ICDS
I.C.E.	ICE
ICFF	ICFF
icf	ICF
ICF	ICF
ICFR	ICFR
ICG	ICG
ICHC	ICHC
I&C	I and C
ic	IC
Ic	IC
I. C.	IC
I.C.	IC
IC	IC
Ici	ICI
ICI	ICI
ICJ	ICJ
ICL	ICL
ICL's	ICL's
ICMA	ICMA
ICME	ICME
I.C.M.	ICM
ICM	ICM
iCN	ICN
ICN	ICN
Ico	ICO
ICO	ICO
ICOP	ICOP
ICPC	ICPC
ICPD	ICPD
ICP	ICP
ICP's	ICP's
ICQ	ICQ
ICRC	ICRC
ICRF	ICRF
ICR	ICR
IcRn	ICRN
ICRP	ICRP
ICRS	ICRS
ICRW	ICRW
ICSA	ICSA
ICSB	ICSB
ICSC	ICSC
ICSE	ICSE
ICSG	ICSG
ics	ICS
ICs	IC's
ICS	ICS
ICSS	ICSS
ICSSR	ICSSR
ICTA	ICTA
ICT	ICT
ICTM	ICTM
ICTP	ICTP
ICTSF	ICTSF
ICTs	ICT's
ICTS	ICTS
ICTU	ICTU
ICTUR	ICTUR
ICTVdB	ICTVDB
ICTV's	ICTV's
ICTY	ICTY
ICU	ICU
ICUN	ICUN
ICU's	ICU's
ICv	ICV
ICV	ICV
ICVS	ICVS
ICWA	ICWA
ICWC	ICWC
ICW	ICW
ICW's	ICW's
iCyt	ICYT
ICZ	ICZ
ICZN	ICZN
IDAF	IDAF
IDBF	IDBF
IDB	IDB
IDBI	IDBI
IDC	IDC
Iddaa	IDDAA
Idd	IDD
ID'd	IDD
IDEF	IDEF
IDE	IDE
IDFA	IDFA
IDFG	IDFG
IDF	IDF
IDFL	IDFL
IDF's	IDF's
IDG	IDG
I. D. H.	IDH
IDH	IDH
id	ID
I. D.	ID
I.D.	ID
ID	ID
Idi	IDI
Idir	IDIR
IDIS	IDIS
IDLHs	IDLH's
IDL	IDL
Idm	IDM
IDM	IDM
IDMR	IDMR
IDMS	IDMS
IDNA	IDNA
IDN	IDN
IDNR	IDNR
IDNR's	IDNR's
IDPs	IDP's
IDRC	IDRC
IDRO	IDRO
IDSA	IDSA
IDSA's	IDSA's
IDSF	IDSF
ids	IDS
ID's	ID's
IDs	ID's
IDV	IDV
IDW	IDW
IDWO	IDWO
IDW's	IDW's
IDx	IDX
IDX	IDX
IEA	IEA
I.E.M.	IEM
IEM	IEM
I.E.S.	IES
IES	IES
i.e.	that  is
Ifa	IFA
IFA	IFA
IFBB	IFBB
IFBC	IFBC
I.F.B.	IFB
IFCC	IFCC
ifc	IFC
IFC	IFC
IFC's	IFC's
IfF	IFF
I. F. F.	IFF
IFF	IFF
IFFI	IFFI
IFFK	IFFK
Ifft	IFFT
IFHA	IFHA
IFHP	IFHP
ifi	IFI
Ifi	IFI
IFI	IFI
IFIP	IFIP
IFIs	IFI's
IFK	IFK
IFLA	IFLA
IFL	IFL
IfM	IFM
IFM	IFM
IFN	IFN
Ifni	IFNI
IFNs	IFN's
IFO	IFO
Ifop	IFOP
IFP	IFP
IFPI	IFPI
IFPRI	IFPRI
IFRC	IFRC
IFR	IFR
IFRS	IFRS
IFRSs	IFRS's
IFSB	IFSB
IFSC	IFSC
IFSTA	IFSTA
IFTA	IFTA
IFTF	IFTF
IFT	IFT
Iga	IGA
IgA	IGA
IGA	IGA
IGA's	IGA's
IGBT	IGBT
IGC	IGC
IGCP	IGCP
IGCSE	IGCSE
IGD	IGD
IGF	IGF
IGFI	IGFI
IGFs	IGF's
IGIB	IGIB
'ig	IG
Ig	IG
I.G.	IG
IG	IG
igi	IGI
IGI	IGI
IgM	IGM
IGM	IGM
IGMP	IGMP
ign	IGN
Ign	IGN
IGN	IGN
IHF	IHF
IHGS	IHGS
IHH	IHH
Ih	IH
I. H.	IH
IH	IH
ihi	IHI
IHI	IHI
IHL	IHL
IHL's	IHL's
IHMC	IHMC
IHME	IHME
ihm	IHM
ihn	IHN
Ihn	IHN
IHOM	IHOM
Ihor	IHOR
IHPK	IHPK
IHRC	IHRC
IHSAA	IHSAA
IHSA	IHSA
IHS	IHS
Iht	IHT
IIA	IIA
IIb	IIB
IIB	IIB
IIc	IIC
IIDC	IIDC
IID	IID
IIDI	IIDI
IIDS	IIDS
IIDX	IIDX
IIED	IIED
IIFA	IIFA
IIF	IIF
IIfx	IIFX
Iiga	IIGA
IIga	IIGA
IIG	IIG
IIgs	IIG's
IIGs	IIG's
IIGS	IIGS
IIGS's	IIGS's
IIHF	IIHF
IIHR	IIHR
IIHS	IIHS
IIIA	IIIA
IIIb	IIIB
IIIB	IIIB
IIIBy	IIIBY
IIIc	IIIC
IIId	IIID
IIIF	IIIF
I. I.	II
I.I.	II
ija	IJA
Ija	IJA
IJA	IJA
IJF	IJF
IJGL	IJGL
IJHCD	IJHCD
IJHL	IJHL
ij	IJ
I. J.	IJ
IJ	IJ
IJN	IJN
Ijok	IJOK
IJSB	IJSB
IJSE	IJSE
IJSEM	IJSEM
IJS	IJS
Ijui	IJUI
IJVM	IJVM
IKBN	IKBN
IKCO	IKCO
IKF	IKF
Ikh	IKH
I.K.	IK
IKK	IKK
IKL	IKL
IKr	IKR
Iksa	IKSA
IKTA	IKTA
Iku	IKU
Ilbe	ILBE
ILB	ILB
ILC	ILC
ILCS	ILCS
ILD	ILD
ILDIS	ILDIS
ILFC	ILFC
ILF	ILF
IL&FS	IL and FS
ili	ILI
Ili	ILI
ILI	ILI
I. L.	IL
I.L.	IL
Ilm	ILM
ILM	ILM
ILM's	ILM's
ILN	ILN
ILP	ILP
ILR	ILR
ILRS	ILRS
ilu	ILU
Ilu	ILU
ILU	ILU
IMbd	IMBD
IMBD	IMBD
IMB	IMB
IMCB	IMCB
IMCI	IMCI
imc	IMC
IMC	IMC
imdb	IMDB
IMDb.	IMDB
IMDb	IMDB
IMDB	IMDB
IMD	IMD
IMD's	IMD's
ime	IME
IME	IME
IMF	IMF
IMG	IMG
I&M	I and M
IMI	IMI
I. M.	IM
I.M.	IM
IMIS	IMIS
IMK	IMK
Iml	IML
IMMEX	IMMEX
Imm	IMM
Imms'	IMM's
imoa	IMOA
IMO's	IMO's
IMPA	IMPA
IMPDH	IMPDH
impr	IMPR
Impr	IMPR
IMPSA	IMPSA
IMR	IMR
IMSLP	IMSLP
iMSNs	IMSN's
Imst	IMST
IMTA	IMTA
IMT	IMT
IMTV	IMTV
IMUK	IMUK
IMU's	IMU's
IMWF	IMWF
INAC	INAC
Inba	INBA
INBA	INBA
INBF	INBF
inb	INB
incl	INCL
INDC	INDC
ind	IND
Ind	IND
IND	IND
INFJ	INFJ
I.N.F.O.	INFO
Infs	INF's
ING	ING
INGR	INGR
inHg	INHG
INH	INH
INI	INI
I. N.	IN
I.N.	IN
InlB	INLB
INL	INL
INM	INM
INPD	INPD
INPE	INPE
InP	INP
INP	INP
INPP	INPP
Inre	INRE
I.N.R.I.	INRI
INR	INR
INSB	INSB
INSDC	INSDC
INSD	INSD
Inspx	INSPX
INSS	INSS
INTF	INTF
Ints	INT's
INTs	INT's
Intu	INTU
INVA	INVA
inv	INV
INXS	INXS
INXS's	INXS's
Ioba	IOBA
IOCG	IOCG
IOC	IOC
IOCP	IOCP
IODP	IODP
IODs	IOD's
IOE	IOE
IOFB	IOFB
IOF	IOF
io.	IO
io	IO
.I.o.	IO
Io.	IO
Io	IO
.IO	IO
I/O	IO
IO	IO
Ioka	IOKA
Iok	IOK
IOL	IOL
IoM	IOM
IOM	IOM
IOPI	IOPI
IOP	IOP
IOPs	IOP's
IORG	IORG
IOR	IOR
IORM	IORM
IOSA	IOSA
IOSB	IOSB
iOS	IOS
Io's	IO's
I/Os	IO's
I.O.'s	IO's
IOS	IOS
IOSR	IOSR
Iosu	IOSU
IoT	IOT
IOT	IOT
I.O.U.	IOU
IOU	IOU
IoW	IOW
IOW	IOW
IPA	IPA
IPA's	IPA's
IPB	IPB
IPCC	IPCC
IPCC's	IPCC's
IPC	IPC
IPCRI	IPCRI
IPCs	IPC's
IPDA	IPDA
IPDI	IPDI
IPD	IPD
IPE	IPE
IPFA	IPFA
IPFI	IPFI
IPF	IPF
IPFP	IPFP
IPFW	IPFW
IPG	IPG
IPH	IPH
ip	IP
Ip	IP
I.P.	IP
IP	IP
IPL	IPL
IPMG	IPMG
IPM	IPM
IPNI	IPNI
IPN	IPN
Ipo	IPO
I.P.O.	IPO
IPO	IPO
IPP	IPP
IPPL	IPPL
IPPs	IPP's
IPPT	IPPT
Ippu	IPPU
iPPV	IPPV
IPR	IPR
iPSC	IPSC
IPSC	IPSC
iPSCs	IPSC's
ipse	IPSE
IPSF	IPSF
iPS	IPS
IPs	IP's
I.P.S.	IPS
IPS	IPS
IPTA	IPTA
IPTC	IPTC
IPTG	IPTG
IPT	IPT
IPTL	IPTL
IPTV	IPTV
IPU	IPU
IPUM	IPUM
IPv	IPV
IPWA	IPWA
IPW	IPW
IPX	IPX
iQ	IQ
I.Q.	IQ
IQ	IQ
IRAC	IRAC
I.R.A.	IRA
IRB	IRB
IRBM	IRBM
IRCA	IRCA
IRC	IRC
IRCM	IRCM
IRCTC	IRCTC
IRCT	IRCT
IRD	IRD
IRDS	IRDS
IREC	IREC
I.R.E.	IRE
IRE	IRE
IRFCA	IRFCA
IRFC	IRFC
IRF	IRF
IRFU	IRFU
IRGC	IRGC
Irgm	IRGM
IRHG	IRHG
IRHT	IRHT
IRIB	IRIB
Irig	IRIG
IRI	IRI
Iril	IRIL
IRIN	IRIN
i'r	IR
ir	IR
Ir	IR
I. R.	IR
I.R.	IR
IR	IR
IRIX	IRIX
Irla	IRLA
IRL	IRL
IRM	IRM
Irmis	IRMI's
IRM's	IRM's
IRNE	IRNE
IRN	IRN
iro	IRO
Iro	IRO
IRO	IRO
IRP	IRP
IRP's	IRP's
IRPS	IRPS
IRQ	IRQ
Irra	IRRA
IRRI	IRRI
IRR	IRR
IRs	IR's
I.R.S.	IRS
IRS	IRS
IRSN	IRSN
I.R.T.	IRT
IRT	IRT
iru	IRU
Iru	IRU
ISA	ISA
ISAv	ISAV
Isba	ISBA
ISBA	ISBA
ISBER	ISBER
ISBHF	ISBHF
ISB	ISB
isbn	ISBN
ISBN	ISBN
ISBNs	ISBN's
ISBO	ISBO
ISCB	ISCB
ISCE	ISCE
isCf	ISCF
ISCI	ISCI
iSC	ISC
Isc	ISC
ISC	ISC
ISCM	ISCM
ISCM's	ISCM's
ISCP	ISCP
ISDA	ISDA
Isd	ISD
ISD	ISD
isdn	ISDN
ISDN	ISDN
ISDS	ISDS
ISDT	ISDT
ISFI	ISFI
ISF	ISF
Isgec	ISGEC
ISG	ISG
ISHC	ISHC
ishq	ISHQ
Ishq	ISHQ
ISHS	ISHS
I. S.	IS
I.S.	IS
ISKB	ISKB
ISK	ISK
Isl	ISL
ISL	ISL
ISMF	ISMF
ISMIR	ISMIR
ISMNs	ISMN's
ISN	ISN
ISNTUC	ISNTUC
ISOGG	ISOGG
ISO	ISO
ISO's	ISO's
I.S.P.C.K.	ISPCK
ISPF	ISPF
ISPI	ISPI
ISP	ISP
ISPL	ISPL
ISPR	ISPR
ISPs	ISP's
Isra'il	ISRAIL
Isra	ISRA
ISRA	ISRA
ISR	ISR
ISRN	ISRN
ISRO	ISRO
ISRP	ISRP
ISSCC	ISSCC
ISSF	ISSF
iss	ISS
Iss	IS's
ISS	ISS
ISSN	ISSN
ISSNs	ISSN's
ISSSSP	ISSSSP
ISSUU	ISSUU
ISTAF	ISTAF
ISTD	ISTD
Isu	ISU
ISU	ISU
ISU's	ISU's
ISWC	ISWC
ISWI	ISWI
ISW	ISW
I.T.A.	ITA
ITA	ITA
ITB	ITB
ITC	ITC
Ite	ITE
ITE	ITE
ITF	ITF
ITG	ITG
ITHF	ITHF
I.T.H.M.	ITHM
ITHs	ITH's
iti	ITI
Iti	ITI
ITI	ITI
I.T.	IT
itk	ITK
Itk	ITK
ITK	ITK
ITM	ITM
ITMO	ITMO
ITN	ITN
ITNNs	ITNN's
ITN's	ITN's
Itoi	ITOI
ITPF	ITPF
iTP	ITP
ITP	ITP
ITRD	ITRD
Itse	ITSE
ITSF	ITSF
ITTF	ITTF
itt	ITT
ITT	ITT
ITUC	ITUC
Itu	ITU
ITU	ITU
ITV	ITV
ITV's	ITV's
ITWF	ITWF
ITW	ITW
Itz	ITZ
IUB	IUB
I.U.C.N.B.	IUCNB
Iucn	IUCN
IUCN	IUCN
IUCN's	IUCN's
IUD	IUD
IUDs	IUD's
IU	IU
IUT	IUT
IUU	IUU
Iuz	IUZ
IVAA	IVAA
IVAW	IVAW
IVB	IVB
I. V.	IV
I.V.	IV
IVL	IVL
IVLP	IVLP
IVM's	IVM's
IVP	IVP
IVPP	IVPP
IVPTC	IVPTC
IVRCL	IVRCL
IVs	IV's
Ivu	IVU
IVWA	IVWA
IWA	IWA
Iwas	IWA's
Iwaz	IWAZ
IWBs	IWB's
IWC	IWC
IWD	IWD
IWF	IWF
IWFL	IWFL
IWF's	IWF's
IWFS	IWFS
IWG	IWG
IWGP	IWGP
iwi	IWI
iw	IW
I. W.	IW
IW	IW
IWL	IWL
IWMF	IWMF
IWM	IWM
IWPR	IWPR
iwrg	IWRG
IWRG	IWRG
IWR	IWR
IWRS	IWRS
IWSA	IWSA
iwspy	IWSPY
Iwuh	IWUH
IWU's	IWU's
I.W.W.	IWW
IWW	IWW
IXA	IXA
IXb	IXB
IXBs	IXB's
IXC	IXC
IXCs	IXC's
IXe	IXE
iXL	IXL
IXO	IXO
ixtle	IXTLE
IXV	IXV
Iya	IYA
IYA	IYA
Iyar	IYAR
IYC	IYC
iyem	IYEM
IYHF	IYHF
Iyi	IYI
iy	IY
I. Y.	IY
I.Y.	IY
IY	IY
J.A.A.	JAA
J. A. B.	JAB
Jaf	JAF
J.A.G.	JAG
JAG	JAG
JAIR	JAIR
J. A.	JA
J.A.K.E.	JAKE
J. A. N.	JAN
J.A.P.	JAP
J.A.S.	JAS
JBA	JBA
JBBA	JBBA
JBB	JBB
JBC	JBC
JBG	JBG
J&B	J and B
jb	JB
J. B.	JB
J.B.	JB
JB	JB
J.B.L.D.	JBLD
JBL	JBL
J.B.M.	JBM
JBM	JBM
JB's	JB's
J. B. S.	JBS
J.B.S.	JBS
JBT	JBT
JBZ	JBZ
JCA	JCA
JCB	JCB
JCC	JCC
JCF	JCF
JCFS	JCFS
J.C.G.	JCG
JCG	JCG
JCGM	JCGM
JCIB	JCIB
JCI	JCI
jcis	JCIS
jc	JC
J. C.	JC
J.C.	JC
JC	JC
JCJC	JCJC
J. C. L.	JCL
JCPA	JCPA
J. C. P.	JCP
JCP	JCP
JCPV	JCPV
JCRB	JCRB
JCR	JCR
JCRs	JCR's
J.C.S.	JCS
JCS	JCS
JCSR	JCSR
JCVI	JCVI
J. C. W.	JCW
JCW	JCW
J. D. A.	JDA
JDA	JDA
JDBC	JDBC
JDC	JDC
JdeBP	JDEBP
J.D.E.	JDE
JDE	JDE
JDENET	JDENET
J.D.F.	JDF
JDF	JDF
jdi	JDI
JDI	JDI
jd	JD
J. D.	JD
J.D.	JD
JD	JD
jdk	JDK
JDK	JDK
J.D.M.	JDM
JDM	JDM
JDO	JDO
JDRF	JDRF
J&D's	J and D's
J.D.s	JD's
JDT	JDT
JDU	JDU
JDV	JDV
J. E. A.	JEA
J.E.A.L.	JEAL
J.E.B.	JEB
J. E. C.	JEC
J. E. E.	JEE
J. E.	JE
J.E.	JE
J.F.G.	JFG
JFH	JFH
jf	JF
J. F.	JF
J.F.	JF
JF	JF
JFK	JFK
JFN	JFN
JFQA	JFQA
JFS	JFS
J. G. A.	JGA
J.G.B.	JGB
JGI	JGI
J. G.	JG
J.G.	JG
J. G. L.	JGL
JGLS	JGLS
J. G. M.	JGM
J.G.M.	JGM
JGO	JGO
JGP	JGP
JGR	JGR
JGR's	JGR's
JGSDF	JGSDF
JGTC	JGTC
JGU	JGU
J.H.B.	JHB
JHB	JHB
J. H. C.	JHC
JHC	JHC
JHED	JHED
J.H.F.	JHF
J.H.H.	JHH
jh	JH
J. H.	JH
J.H.	JH
JH	JH
JHL	JHL
J. H. M.	JHM
J.H.R.	JHR
JHs	JH's
JHS	JHS
JHSVs	JHSV's
JHud	JHUD
JHU	JHU
J. I.	JI
J.I.	JI
J.J.A.	JJA
JJB	JJB
J. J. C.	JJC
J.J.G.	JJG
J&J	J and J
J. J.	JJ
J.J.	JJ
JJ	JJ
JJK	JJK
J. J. L.	JJL
J.J.M.	JJM
J.J.N.	JJN
JJN	JJN
Jka	JKA
JKA	JKA
JKC	JKC
jkd	JKD
JKH	JKH
J&K	J and K
J.K. J.	JKJ
J. K.	JK
J.K.	JK
JK	JK
JKNPP	JKNPP
J. K. S.	JKS
JKT	JKT
jkx	JKX
JKX	JKX
JLA	JLA
J.L.B.	JLB
JLB	JLB
JLC	JLC
J. L. E.	JLE
J.L.E.	JLE
JLG	JLG
JLI	JLI
J. L.	JL
J.L.	JL
J.L.L.	JLL
JLM	JLM
JLO's	JLO's
JLPGA	JLPGA
JLP	JLP
JLS	JLS
JLT	JLT
JMA	JMA
JMBG	JMBG
J.M.C.	JMC
JMC	JMC
J. M. D.	JMD
JMD	JMD
J. M. E.	JME
JMI	JMI
J. M. J.	JMJ
J.M.J.	JMJ
J. M.	JM
J.M.	JM
JMKR	JMKR
J. M. L.	JML
JML	JML
JMM	JMM
JMP	JMP
JMS	JMS
JMU	JMU
JMV	JMV
J. M. W.	JMW
J.M.W.	JMW
JMX	JMX
JNA	JNA
jnb	JNB
JNF	JNF
JNG	JNG
JNI	JNI
J. N.	JN
J.N.	JN
JN	JN
JNK	JNK
J. N. L.	JNL
Jno	JNO
JNPT	JNPT
jnr	JNR
JNR	JNR
JNS's	JNS's
JOJ	JOJ
J. O.	JO
J.O.	JO
J.P.D.B.	JPDB
J. P. F.	JPF
JPF	JPF
jpg	JPG
JPG	JPG
JPH	JPH
J&P	J and P
jp	JP
J.P.	JP
JP	JP
J.P.R.	JPR
J.Q.	JQ
JQ	JQ
J.R.A.	JRA
JRA	JRA
J.R.C.	JRC
JRC	JRC
J.R.E.	JRE
JRG	JRG
JRHU	JRHU
J. R. I.	JRI
J&R	J and R
J. R.	JR
J.R.	JR
JR	JR
JRJ's	JRJ's
Jr.	junior
jr.	junior
Jr	junior
jr	junior
JRPG	JRPG
J. R. P.	JRP
J. R. R.	JRR
J.R.R.	JRR
J.R.'s	JR's
JRSP	JRSP
J. R. T.	JRT
JRU	JRU
JRX	JRX
JSA	JSA
JSAP	JSAP
JSA's	JSA's
jsb	JSB
JSCA	JSCA
JSC	JSC
J.S.D.	JSD
JSD	JSD
JSE	JSE
JSF	JSF
JSH	JSH
Js	J's
J. S.	JS
J.S.	JS
JS	JS
J.S.K.	JSK
J.S.L.	JSL
JSL	JSL
J. S. M.	JSM
JSM	JSM
JSNN	JSNN
JSOC	JSOC
JSO	JSO
JSP	JSP
JSPS	JSPS
JSR	JSR
JSS	JSS
JSW	JSW
JSW's	JSW's
JSX	JSX
JTA	JTA
J.T.B.	JTB
JTB	JTB
JTC	JTC
JTF	JTF
JTG	JTG
JTI	JTI
J&T	J and T
J. T.	JT
J.T.	JT
JT	JT
JT&KW	JT and KW
JTL	JTL
JTO	JTO
JTR	JTR
JTRO	JTRO
JTS	JTS
JTTF	JTTF
JTT	JTT
JTV	JTV
J. U.	JU
J.U.L.I.A.	JULIA
J.V.B.	JVB
JVB	JVB
JVC	JVC
J.V.E.	JVE
JVG	JVG
JVH	JVH
J&V	J and V
J. V.	JV
J.V.	JV
JV	JV
JVM	JVM
JVNW	JVNW
JVP	JVP
JVRA	JVRA
JVS	JVS
Jwa	JWA
J. W. A.	JWA
J. W. B.	JWB
JWB	JWB
J.W.C. U.S.	JWCUS
JWHA	JWHA
J.W.J.	JWJ
J. W.	JW
J.W.	JW
JWM	JWM
J. W. P.	JWP
JWP	JWP
JWRC	JWRC
J. W. S.	JWS
J.W.S.	JWS
JWS	JWS
JWST	JWST
JWT	JWT
jx	JX
JX	JX
J.X.W.P.	JXWP
JYJ	JYJ
JYJ's	JYJ's
J. Y.	JY
J.Y.	JY
JY	JY
Jym	JYM
Jymn	JYMN
JYP	JYP
J. Y. S.	JYS
J. Z.	JZ
J.Z.	JZ
JZ	JZ
K.A.A.	KAA
K. A.	KA
K.A.	KA
K.A.N.	KAN
K. A. R.	KAR
K.A.S.	KAS
KBBI	KBBI
KBB	KBB
KBCI	KBCI
KBC	KBC
KBCO	KBCO
KBD	KBD
KBE	KBE
KBFC	KBFC
KBFL	KBFL
KBFR	KBFR
KBGD	KBGD
KBG	KBG
KBIG	KBIG
kbi	KBI
K&B	K and B
K. B.	KB
K.B.	KB
KBKR	KBKR
KBKS	KBKS
KBKW	KBKW
KBL	KBL
KBMT	KBMT
KBND	KBND
KBNZ	KBNZ
KBO	KBO
KBRC	KBRC
KBR	KBR
KBS	KBS
KBSN	KBSN
KCB	KCB
KCBS	KCBS
KCCC	KCCC
KCCI	KCCI
KCC	KCC
KCCO	KCCO
KCDC	KCDC
K. C. D.	KCD
KCD	KCD
KCED	KCED
KCET	KCET
KCG	KCG
KCHS	KCHS
K.C.I.E.	KCIE
K. C.	KC
K.C.	KC
KCK	KCK
KCKM	KCKM
KCLU	KCLU
K.C.M.G.	KCMG
KCMG	KCMG
KCNA	KCNA
KCNH	KCNH
KCNJ	KCNJ
KCN	KCN
KCNN	KCNN
KCNQ	KCNQ
KCNV	KCNV
KCPD	KCPD
KCPI	KCPI
KCPM	KCPM
KCPQ	KCPQ
KCPQ's	KCPQ's
KCQL	KCQL
KCRA	KCRA
KCRC	KCRC
KCRH	KCRH
KCR	KCR
KCRW	KCRW
KCSD	KCSD
KCSG	KCSG
K.C.S.I.	KCSI
KCSI	KCSI
K.C.'s	KC's
KCS	KCS
KCSP	KCSP
KCTD	KCTD
KCT	KCT
KCTL	KCTL
KCTV	KCTV
KCUB	KCUB
KCU	KCU
KCVO	KCVO
KCYX	KCYX
kDa	KDA
KDA	KDA
kdal	KDAL
KDAL	KDAL
KDB	KDB
KDCE	KDCE
KDCO	KDCO
KDDG	KDDG
KDDI	KDDI
KDD	KDD
KDE	KDE
KDFW	KDFW
KDFX	KDFX
K. D. G.	KDG
KDGS	KDGS
KDHS	KDHS
KDKA	KDKA
K&D	K and D
kd	KD
K. D.	KD
K.D.	KD
KD	KD
KDP	KDP
KDPM	KDPM
KDR	KDR
K. D.'s	KD's
K.D.'s	KD's
KDS	KDS
ke	KE
Ke	KE
K. E.	KE
K.E.	KE
KE	KE
KFAC	KFAC
KFAED	KFAED
KFAI	KFAI
KFA	KFA
KFBK	KFBK
KFBT	KFBT
KFCC	KFCC
KFCD	KFCD
kfc	KFC
K.F.C.	KFC
KFC	KFC
KFC's	KFC's
KFD	KFD
KFDM	KFDM
KFEM	KFEM
KFFL	KFFL
KFH	KFH
KFI	KFI
KFJB	KFJB
K.F.	KF
KFLX	KFLX
KFMB's	KFMB's
KFMJ	KFMJ
K. F. M.	KFM
K.F.M.	KFM
KFOR	KFOR
KFQC	KFQC
KFQ	KFQ
KFRC	KFRC
KFRC's	KFRC's
KFRD	KFRD
KFRG	KFRG
KFRH	KFRH
KFRO	KFRO
KFSD	KFSD
KFSN	KFSN
KFST	KFST
KFT	KFT
KFTL	KFTL
KFUM's	KFUM's
KFVD	KFVD
KFV	KFV
KFWB	KFWB
KFXO	KFXO
KFYO's	KFYO's
KGA	KGA
K.G.B.	KGB
KGB	KGB
KGC	KGC
KGPH	KGPH
KGP	KGP
KGRI	KGRI
kgr	KGR
KGRK	KGRK
KGS	KGS
kgt	KGT
KGT	KGT
KGTV	KGTV
KgU	KGU
KGU	KGU
KGUN	KGUN
kgv	KGV
K.G.V.	KGV
KGWB	KGWB
KGW	KGW
KHHZ	KHHZ
KHI	KHI
Khizr	KHIZR
KHJ	KHJ
K. H.	KH
K.H.	KH
KH	KH
KHK	KHK
KHKV	KHKV
Khlav	KHLAV
KHL	KHL
KHL's	KHL's
Khmu	KHMU
KHMY	KHMY
KHOJ	KHOJ
KHOW	KHOW
KHQA	KHQA
KHQ	KHQ
Khri	KHRI
Khru	KHRU
KHRW	KHRW
KHSAA	KHSAA
KHS	KHS
KHTL	KHTL
KHTZ	KHTZ
KHUI	KHUI
KHUT	KHUT
KHWI	KHWI
K.I.D.	KID
K. I.	KI
K.I.	KI
K.I.M.	KIM
KIP	KIP
K.I.S.S.	KISS
KJCE	KJCE
KJCT	KJCT
KJEF	KJEF
Kjer	KJER
KJHK	KJHK
KJI	KJI
KJIN	KJIN
kj	KJ
K. J.	KJ
K.J.	KJ
KJ	KJ
KJKP	KJKP
KJMM	KJMM
KJNE	KJNE
KJNW	KJNW
Kjop	KJOP
KJo's	KJO's
KJQY	KJQY
KJV	KJV
KJZI	KJZI
KKBL	KKBL
KKBQ	KKBQ
KKCR	KKCR
KKDA	KKDA
K.K.E.	KKE
KKE	KKE
K. K.	KK
K.K.	KK
KKMC	KKMC
KKMI	KKMI
KKM	KKM
KKMX	KKMX
KKRG	KKRG
KKR	KKR
KKSF	KKSF
KK's	KK's
KKSY	KKSY
KKT	KKT
KLA	KLA
KLBK	KLBK
KLBM	KLBM
KLCI	KLCI
KLC	KLC
KLDS	KLDS
Kle	KLE
KLE	KLE
KLF	KLF
KLGH	KLGH
KLH	KLH
KLK	KLK
kl	KL
K. L.	KL
K.L.	KL
KL	KL
KLKS	KLKS
KLLP	KLLP
KLLV	KLLV
KLM	KLM
KLN's	KLN's
KLQQ	KLQQ
KLQT	KLQT
KLRY	KLRY
KLSC	KLSC
KLSD	KLSD
KLS	KLS
KLSX	KLSX
KLT	KLT
KLX	KLX
KMB	KMB
KMC	KMC
KMD	KMD
KMGO	KMGO
KMGT	KMGT
KMIH	KMIH
KMIR	KMIR
KMITL	KMITL
KMJ	KMJ
K&M	K and M
KMK	KMK
km	KM
K. M.	KM
K.M.	KM
KM	KM
KMLA	KMLA
KML	KML
KMME	KMME
KMML	KMML
KMRL	KMRL
KMS	KMS
KMSP	KMSP
KMT	KMT
KMTP	KMTP
KMTV	KMTV
KMVA	KMVA
KMXW	KMXW
KMZ	KMZ
KNFM	KNFM
KNHP	KNHP
K&N	K and N
kn	KN
K. N.	KN
K.N.	KN
KN	KN
KNKT	KNKT
KNLA	KNLA
KNMI	KNMI
KNNV	KNNV
KNPN	KNPN
KNPR	KNPR
KNPU	KNPU
KNRE	KNRE
KNRS	KNRS
KNS	KNS
KNSM	KNSM
KNST	KNST
KNTH	KNTH
K.N.T.	KNT
KNTN	KNTN
KNTU	KNTU
KNVA's	KNVA's
KNVB	KNVB
KNVN	KNVN
KNX	KNX
KNXT	KNXT
K.O.D.	KOD
k'o	KO
K. O.	KO
K.O.	KO
KOTC	KOTC
KOTD	KOTD
K.O.T.	KOT
KOWL	KOWL
K. P. A. C.	KPAC
KPAC	KPAC
KPA	KPA
KPAN	KPAN
KPCC	KPCC
KPC	KPC
KPD	KPD
KPE	KPE
KPIF	KPIF
KPI	KPI
KPIs	KPI's
K&P	K and P
K. P.	KP
K.P.	KP
KP	KP
KPLC	KPLC
KPL	KPL
KPLZ	KPLZ
KPMG	KPMG
KPM	KPM
KPNA	KPNA
KPNB	KPNB
KPO	KPO
Kppen	KPPEN
KPPV	KPPV
KPS	KPS
kptm	KPTM
KPTV	KPTV
KPU	KPU
KPVD	KPVD
KPVX	KPVX
KPWR	KPWR
KPXE	KPXE
KQA	KQA
KQED	KQED
KQHN	KQHN
KQKK	KQKK
KQKS	KQKS
KQLT	KQLT
KQLZ	KQLZ
KQMO	KQMO
KQV	KQV
KQXR	KQXR
KRBM	KRBM
krc	KRC
KRCR	KRCR
KRCs	KRC's
KRF	KRF
KRH	KRH
K.R.I.T.	KRIT
K.R.I.T.'s	KRIT's
Krka	KRKA
KRKC	KRKC
KRK	KRK
kr	KR
K. R.	KR
K.R.	KR
KR	KR
KRMT	KRMT
Krne	KRNE
KRNS	KRNS
KRNV	KRNV
KROQ	KROQ
kroz	KROZ
Kroz	KROZ
KRPS	KRPS
KRRT	KRRT
K. R. S.	KRS
KRS	KRS
KRT	KRT
Kru	KRU
KRU	KRU
KRWC	KRWC
KRX	KRX
K.R.Y.	KRY
KRZA	KRZA
ksa	KSA
KSA	KSA
K. S. B.	KSB
KSBW	KSBW
KSBY	KSBY
KSCB	KSCB
KSC	KSC
KSCO	KSCO
KSC's	KSC's
KSCS	KSCS
KSDB	KSDB
KSDO	KSDO
KSEB	KSEB
KSEG	KSEG
KSE	KSE
KSEQ	KSEQ
kset	KSET
KSET	KSET
Kseur	KSEUR
Ksevt	KSEVT
KSFO	KSFO
KSG	KSG
KSHB	KSHB
KSI's	KSI's
KSJR	KSJR
KSKJ	KSKJ
KSKK	KSKK
K.S.K.	KSK
KSK	KSK
ks	KS
K. S.	KS
K.S.	KS
KS	KS
KSLC	KSLC
KSL	KSL
KSLM	KSLM
KSLU	KSLU
KSMB	KSMB
KSNR	KSNR
KSNV	KSNV
KSP	KSP
KSPS	KSPS
KSTE	KSTE
KSTH	KSTH
KST	KST
KSTP	KSTP
KSU	KSU
K.S.V.	KSV
KSWD	KSWD
KSWT	KSWT
KSWW	KSWW
KSYL	KSYL
KSZR	KSZR
Ktav	KTAV
KTAV	KTAV
KTBS	KTBS
KTCC	KTCC
KTC	KTC
KTCZ	KTCZ
KTDA	KTDA
KTDD	KTDD
KTE	KTE
KTH	KTH
KT&K	KT and K
kt	KT
K. T.	KT
K.T.	KT
KT	KT
KTKZ	KTKZ
KTLA	KTLA
K. T. M.	KTM
KTM	KTM
KTN	KTN
KTOK	KTOK
KTO	KTO
KTRE	KTRE
KTRH	KTRH
KTRK	KTRK
KTR	KTR
KT's	KT's
KTSM	KTSM
KTT	KTT
KTTN	KTTN
KTTV	KTTV
KTU	KTU
KTUM	KTUM
KTVA	KTVA
KTVK	KTVK
KTVS	KTVS
KTVT	KTVT
KTVU	KTVU
KTVZ	KTVZ
KTWD's	KTWD's
KTWO	KTWO
KTX	KTX
KTXL	KTXL
Kuaa	KUAA
Kud	KUD
KUFM	KUFM
KUGB	KUGB
kuih	KUIH
K. U.	KU
K.U.	KU
Kutb	KUTB
KUTV	KUTV
KUUU	KUUU
KUWL	KUWL
KUYI	KUYI
KVAB	KVAB
KVBC	KVBC
KVB	KVB
K.V.G.K.	KVGK
KVHV	KVHV
Kvik	KVIK
KVI	KVI
Kvit	KVIT
KVIT	KVIT
KVK	KVK
K. V.	KV
K.V.	KV
KVLO	KVLO
KVLY	KVLY
KVM	KVM
KVMRT	KVMRT
KVMX	KVMX
KVNG	KVNG
KVN	KVN
KVP	KVP
KVTV	KVTV
KVVS's	KVVS's
KVVV	KVVV
Kvyat	KVYAT
KVZ	KVZ
kwa	KWA
KWBM	KWBM
KWC	KWC
KWD	KWD
KWEI	KWEI
kwe	KWE
KWG	KWG
KWJJ	KWJJ
KWKH	KWKH
KWKW	KWKW
KWMR	KWMR
KWMT	KWMT
KWNA	KWNA
KWNK	KWNK
KWOA	KWOA
KWP	KWP
KWPT	KWPT
KWQC	KWQC
KWRE	KWRE
KWRU	KWRU
KWSB	KWSB
KWSX	KWSX
KWU	KWU
KWWL's	KWWL's
KXAN	KXAN
KXAS	KXAS
KXI	KXI
KXJB	KXJB
KXKS	KXKS
KX	KX
KXLX	KXLX
KXLY	KXLY
KXMC	KXMC
KXNA	KXNA
KXOL's	KXOL's
KXTA	KXTA
KXTN	KXTN
KXTX	KXTX
KYAY	KYAY
KYBE	KYBE
KYEZ	KYEZ
KYNM	KYNM
Kyse	KYSE
KYSL	KYSL
KYTC	KYTC
kyt	KYT
Kyt	KYT
KYW	KYW
kz	KZ
K. Z.	KZ
KZ	KZ
KZLZ	KZLZ
KZMP	KZMP
KZMU	KZMU
KZQX	KZQX
KZZQ	KZZQ
L. A. G.	LAG
L. A.	LA
L.A.'s	LA's
Lay's	LAY's
L.B.A.	LBA
LBA	LBA
LBCC	LBCC
LBC	LBC
LBC's	LBC's
LBE	LBE
LBF	LBF
LBi	LBI
LBJ	LBJ
LBJ's	LBJ's
L. B.	LB
L.B.	LB
LB	LB
LBL	LBL
LBM	LBM
LBN	LBN
LBNL	LBNL
LBP	LBP
LBPs	LBP's
LBR	LBR
LBS	LBS
LBV	LBV
LBW	LBW
LCAC	LCAC
LCA	LCA
LCAs	LCA's
LCAS	LCAS
L.C.B.	LCB
LCBL	LCBL
LCBM	LCBM
lcc	LCC
LCC	LCC
LCCN	LCCN
LCCs	LCC's
LCCS	LCCS
LCDB	LCDB
LCD	LCD
LCDP	LCDP
LC&DR	LC and DR
LCDR	LCDR
LCDs	LCD's
L.C.E.	LCE
LCFC	LCFC
LCF	LCF
LCH	LCH
LCI	LCI
LCIs	LCI's
L. C.	LC
L.C.	LC
LC	LC
LCL	LCL
LCMC	LCMC
LCM	LCM
LCMR	LCMR
LCMV	LCMV
lcn	LCN
LCO	LCO
LCP	LCP
LCQ	LCQ
LCR	LCR
LCSB	LCSB
LCSC	LCSC
LC's	LC's
LCS	LCS
LCSs	LCS's
LCST	LCST
LCT	LCT
LCTs	LCT's
LCU	LCU
LCV	LCV
LCVP	LCVP
LCVPs	LCVP's
LCZ	LCZ
Lda	LDA
LDA	LDA
LDAP	LDAP
LDB	LDB
LDBV	LDBV
L.D.C.	LDC
LDC	LDC
LDCM	LDCM
LDCs	LDC's
LDD	LDD
LDDP	LDDP
LDF	LDF
LDH	LDH
L.D.I.	LDI
LDK	LDK
L. D.	LD
L.D.	LD
LDL	LDL
LDLR	LDLR
LDM	LDM
LDMR	LDMR
LDN	LDN
LDP	LDP
LDS	LDS
LDU	LDU
LDV	LDV
LEB	LEB
L. E.	LE
L.E.	LE
LFA	LFA
L.F.C.	LFC
LFC	LFC
L.F.D.	LFD
LFE	LFE
LFFCs	LFFC's
LFF	LFF
LFG	LFG
LFHC	LFHC
LFH	LFH
L. F.	LF
L.F.	LF
LFL	LFL
LFM	LFM
LFOC	LFOC
LFO	LFO
LFOM	LFOM
LFPB	LFPB
LFP	LFP
LFQD	LFQD
LFRJ	LFRJ
LFR	LFR
LFs	LF's
LFS	LFS
LFSRs	LFSR's
LFTR	LFTR
LFXA	LFXA
LGA	LGA
LGB	LGB
LGBTI	LGBTI
LGBT	LGBT
LGBTQ	LGBTQ
LGC	LGC
LGD	LGD
LGI	LGI
L. G.	LG
L.G.	LG
LG	LG
LGMB	LGMB
LGMs	LGM's
LGN	LGN
LGPL	LGPL
LGPZ	LGPZ
LG&RDD	LG and RDD
LGR	LGR
LGs	LG's
LGS	LGS
LGTB	LGTB
LGT's	LGT's
LGU	LGU
LGUs	LGU's
LGV	LGV
LGVs	LGV's
Lha	LHA
LHB	LHB
L. H. C.	LHC
LHC	LHC
LHD	LHD
LHFP	LHFP
LHICE	LHICE
LHI	LHI
L. H.	LH
L.H.	LH
LHMC	LHMC
L.H.M.	LHM
LHO	LHO
L. H. P.	LHP
LHP	LHP
LHS	LHS
LHW	LHW
LHX	LHX
LHY	LHY
L. I.	LI
L.I.	LI
LJBL	LJBL
Lje	LJE
LJJ	LJJ
L. J. K.	LJK
L. J.	LJ
L.J.	LJ
L.J.V.	LJV
LKB	LKB
LKG	LKG
LKK	LKK
L. K.	LK
LK	LK
LKL	LKL
LKML	LKML
LKPR	LKPR
LKRN	LKRN
lks	LKS
LKS	LKS
LKTI	LKTI
Llapi	LLAPI
LLAW	LLAW
L.L.B.	LLB
LLB	LLB
LLCC	LLCC
L.L.C.	LLC
LLC	LLC
LLD	LLD
LL.D	LLD
lle	LLE
LLE	LLE
LLHS	LLHS
lli	LLI
LLI	LLI
L&L	L and L
LLLE	LLLE
L. L.	LL
L.L.	LL
LL	LL
LLL	LLL
LLLP	LLLP
LLM	LLM
LLMNR	LLMNR
LLPFX	LLPFX
llp	LLP
LLP	LLP
LLPX	LLPX
LLRW	LLRW
LLT	LLT
LLTV	LLTV
llu	LLU
LLVM	LLVM
LLWS	LLWS
LMA	LMA
LMC	LMC
LMCT	LMCT
LMDB	LMDB
LMDC	LMDC
LMD	LMD
LME	LME
LMFAO's	LMFAO's
LMFF	LMFF
LMG	LMG
LMGs	LMG's
LMGTE	LMGTE
LMH	LMH
LMHS	LMHS
lm	LM
L. M.	LM
L.M.	LM
LM	LM
LMM	LMM
LMP	LMP
LMPs	LMP's
LMQ	LMQ
LMQs	LMQ's
L.M.S.	LMS
LMS	LMS
LMT	LMT
LMTP	LMTP
LMU	LMU
LMWH	LMWH
LMX	LMX
LnAIB	LNAIB
LNA	LNA
LNAV	LNAV
LNBF	LNBF
LNB	LNB
L.N.C.	LNC
LNCS	LNCS
L.N.E.R.	LNER
LNER	LNER
LNFS	LNFS
LNG	LNG
LNH	LNH
L&N	L and N
L. N.	LN
L.N.	LN
L.O.C.'s	LOC's
Lokk	LOKK
l'OL	LOL
L.O.L.	LOL
L. O.	LO
L.O.	LO
L.O.V.E.	LOVE
L.O.V.	LOV
LOXL	LOXL
LPA	LPA
L.P.A.M.	LPAM
LPAM	LPAM
LPARs	LPAR's
LPAVS	LPAVS
LPBG	LPBG
L.P.B.	LPB
LPB	LPB
LPC	LPC
LPCM	LPCM
LPDA	LPDA
LPDR	LPDR
LPE	LPE
LPF	LPF
LPFM	LPFM
LPGA	LPGA
LPG	LPG
L.P.H.	LPH
LPH	LPH
LPI	LPI
LPLA	LPLA
L&P	L and P
LPL	LPL
lp	LP
L. P.	LP
L.P.	LP
LP	LP
L&PM	L and PM
LPMN	LPMN
LPMud	LPMUD
LPMUD	LPMUD
LPN	LPN
LPO	LPO
LPRP	LPRP
LPSC	LPSC
LP's	LP's
LPs	LP's
LPS	LPS
LPSN	LPSN
LPTB	LPTB
LPThe	LPTHE
LPTV	LPTV
LQ	LQ
LRAD	LRAD
LRA	LRA
LRCD	LRCD
LRC	LRC
L.R.C.P.	LRCP
LRCP	LRCP
LRDG	LRDG
LRG	LRG
lr	LR
L. R.	LR
L.R.	LR
LR	LR
LRO	LRO
L.R.P.C.	LRPC
LRP	LRP
LRPPRC	LRPPRC
LRRI	LRRI
LRRP	LRRP
LRS	LRS
LRTA	LRTA
LRT	LRT
LRTR	LRTR
LRTs	LRT's
LRVs	LRV's
LRY	LRY
LSAC	LSAC
LSA	LSA
LSBC	LSBC
LSB	LSB
LSC	LSC
LSCS	LSCS
LSDHH	LSDHH
L.S.D.	LSD
LSD	LSD
LSDP	LSDP
LSDs	LSD's
LSE	LSE
LSF	LSF
LSG	LSG
LSH	LSH
LSi	LSI
LSI	LSI
LSJ	LSJ
LSK	LSK
L.S.L.	LSL
ls	LS
Ls	L's
L. S.	LS
L.S.	LS
LSM	LSM
LSO	LSO
LSP	LSP
LSPN	LSPN
LSQC	LSQC
LSRI	LSRI
L. S. R.	LSR
LSS	LSS
LSSP	LSSP
LSSR	LSSR
LST	LST
LSTM	LSTM
LSTs	LST's
LSUA	LSUA
LSU	LSU
LSU's	LSU's
LSVCCs	LSVCC's
LSV	LSV
LSWR	LSWR
LTAF	LTAF
L. T. B.	LTB
LTB	LTB
LTCF	LTCF
LTCI	LTCI
L. T. C.	LTC
L.T.C.	LTC
LTC	LTC
Ltda	LTDA
LTDA	LTDA
Ltd.	limited
LTE	LTE
LTFA	LTFA
LTHS	LTHS
LTI	LTI
LTK	LTK
L&T	L and T
Lt.	lieutenant
LTL	LTL
lt	LT
L. T.	LT
L.T.	LT
L.T.M.	LTM
LTM	LTM
LTMPS	LTMPS
LTN	LTN
ltoh	LTOH
LTP	LTP
LTRPC	LTRPC
LTTE	LTTE
LTTR	LTTR
LTU	LTU
LTV	LTV
L. U.	LU
lv	LV
L. V.	LV
L.V.	LV
LV	LV
LVMH	LVMH
LWDB	LWDB
LWD	LWD
LWDS	LWDS
LWE	LWE
LWF	LWF
LWH	LWH
L. W.	LW
L.W.	LW
L.Y.	LY
L&YR	L and YR
M.A.D.E.	MADE
M.A.D.	MAD
M.A.J.	MAJ
M.A.K.	MAK
M. A.	MA
M.A.	MA
M&A	M and A
M. A. O.	MAO
M.A.O.	MAO
M.A.R.	MAR
M.A.S.K.	MASK
M.A.S.	MAS
M.A.S.S.	MASS
M.B.A.	MBA
M.B.B.S.	MBBS
MBBS	MBBS
MBC	MBC
MBC's	MBC's
MBDA	MBDA
MBD	MBD
M.B. D.P.M.	MBDPM
M.B.E.	MBE
MBE	MBE
Mbewu	MBEWU
MBF	MBF
MBFW	MBFW
MBGN	MBGN
MBH	MBH
mbi	MBI
MBI	MBI
M. B. J.	MBJ
MBJ	MBJ
MBK	MBK
MBL	MBL
M. B.	MB
M.B.	MB
MBM	MBM
MBNA	MBNA
mBo	MBO
MBO	MBO
MBPJ	MBPJ
MBP	MBP
Mbre	MBRE
mbr	MBR
MBR	MBR
MBSE	MBSE
MBSI	MBSI
MBS	MBS
MBTI	MBTI
MBT	MBT
MBU's	MBU's
MBX	MBX
MCAF	MCAF
MCAL	MCAL
M.C.A.	MCA
MCA	MCA
MCA's	MCA's
MCAS	MCAS
MCB	MCB
M. C. C.	MCC
M.C.C.	MCC
MCC	MCC
MCC's	MCC's
MCCs	MCC's
MCCU	MCCU
MCDA	MCDA
MCDC	MCDC
MCD	MCD
MCDM	MCDM
MCE	MCE
MCFA	MCFA
M. C. F.	MCF
MCF	MCF
MCFM	MCFM
MCGJCW	MCGJCW
MCG	MCG
MCI	MCI
MCJ	MCJ
MCLA	MCLA
MCL	MCL
M. C.	MC
M.C.	MC
MCMC	MCMC
M. C. M.	MCM
MCM	MCM
MCN	MCN
MCO	MCO
MCOT's	MCOT's
MCPC	MCPC
MCPI	MCPI
MCP	MCP
MCPON	MCPON
MCPP	MCPP
MCQ	MCQ
MCRD	MCRD
MCR	MCR
MCRP	MCRP
MCSBA	MCSBA
MCs	MC's
M.C. S.	MCS
MCS	MCS
MCST	MCST
MCTFS	MCTFS
MCT	MCT
MCTU	MCTU
MCTV	MCTV
MCU	MCU
MCV	MCV
MCVTS	MCVTS
MCW	MCW
mcyG	MCYG
MCYO	MCYO
MCZ	MCZ
MDAA	MDAA
MDAH	MDAH
MDA	MDA
mdb	MDB
MDB	MDB
MDC	MDC
MDC's	MDC's
MDCs	MDC's
MDCT	MDCT
mdDA	MDDA
MD&DI	MD and DI
Mde	MDE
MDE	MDE
MDF	MDF
MDG	MDG
MDGs	MDG's
MDH	MDH
MDHUs	MDHU's
mDia	MDIA
MDIB	MDIB
MDic	MDIC
MDI	MDI
MDJT's	MDJT's
MDK	MDK
mdla	MDLA
MDL	MDL
MDMA	MDMA
md	MD
M. D.	MD
M.D.	MD
MD	MD
MDM	MDM
MDNA	MDNA
M.D.N.	MDN
MDPD's	MDPD's
MDP	MDP
MDPPP	MDPPP
MDPS	MDPS
MDPV	MDPV
MDQ	MDQ
MDRC	MDRC
mdr	MDR
MDR	MDR
MDT	MDT
MDV	MDV
MDX	MDX
M. E.	ME
M.E.	ME
M.E.N.	MEN
M. E. P.	MEP
M.F.A.	MFA
MFA	MFA
MFB	MFB
MFCC	MFCC
MFC	MFC
MFCS	MFCS
MFD	MFD
MFDs	MFD's
MFe	MFE
MFF	MFF
MFG	MFG
MFI	MFI
MFJ	MFJ
MFK	MFK
M. F.	MF
M.F.	MF
MFMF	MFMF
MFM	MFM
MFN	MFN
MFNW	MFNW
MFP	MFP
MFR	MFR
MFS	MFS
MFS's	MFS's
MFTBC	MFTBC
MFT	MFT
MFTs	MFT's
Mgadla	MGADLA
Mgal	MGAL
mga	MGA
Mga	MGA
MGA	MGA
MGB	MGB
Mgbo	MGBO
MGCCC	MGCCC
MGC	MGC
MGE	MGE
MGen	MGEN
MGG	MGG
MGH	MGH
MGIMO	MGIMO
MGIT	MGIT
MGJH	MGJH
MGK	MGK
M.G.L.	MGL
M&G	M and G
M. G.	MG
M.G.	MG
M. G. M.	MGM
MGM	MGM
MGM's	MGM's
MGMT	MGMT
M&GN	M and GN
MGN	MGN
MGO	MGO
MGP	MGP
M&GR's	M and GR's
Mha	MHA
M.H.A.	MHA
MHA	MHA
MHB's	MHB's
MHC	MHC
MHCs	MHC's
MHD	MHD
MHI	MHI
MHK	MHK
MH&L	MH and L
MHL	MHL
M&H	M and H
M. H.	MH
M.H.	MH
Mhor	MHOR
Mhow	MHOW
MHPL	MHPL
M.H.P.	MHP
MHP	MHP
MHP's	MHP's
MHRA	MHRA
M. H. R.	MHR
MHSA	MHSA
MHSC	MHSC
MHS	MHS
MHT	MHT
M.I.A.	MIA
M.I.A.'s	MIA's
M.I.C.M.	MICM
M.I.H.	MIH
M&I	M and I
M. I.	MI
M.I.	MI
M.I.N.	MIN
M.I.R.V.	MIRV
M.I.S.	MIS
M.I.T.	MIT
MJAHL's	MJAHL's
M.J.A.	MJA
MJA	MJA
MJBHA	MJBHA
MJB	MJB
MJC	MJC
M.J.F.	MJF
MJF	MJF
MJG	MJG
MJHL	MJHL
MJHL's	MJHL's
M&J	M and J
M. J.	MJ
M.J.	MJ
M. J. Y.	MJY
MKBHD	MKBHD
MKB	MKB
MKDE	MKDE
MKE	MKE
MKFM	MKFM
MKG	MKG
MKK	MKK
MKMF	MKMF
M. K.	MK
M.K.	MK
MKNG	MKNG
MKP	MKP
MKRN	MKRN
MKs	MK's
MKS	MKS
MKT	MKT
MKTO	MKTO
MKTV	MKTV
MKZ's	MKZ's
M.L.A.	MLA
MLA	MLA
MLANA	MLANA
MLAs	MLA's
MLB	MLB
MLBPA	MLBPA
MLCA	MLCA
mlc	MLC
M.L.C.	MLC
MLC	MLC
MLCs	MLC's
MLD	MLD
MLE	MLE
MLF	MLF
mlg	MLG
MLG	MLG
MLH	MLH
MLIA	MLIA
mli	MLI
MLI	MLI
MLIM	MLIM
MLK	MLK
MLK's	MLK's
Mlle	MLLE
MLL	MLL
MLLT	MLLT
M&L	M and L
M. L.	ML
M.L.	ML
MLM	MLM
MLND	MLND
M.L.N.	MLN
MLN	MLN
MLPH	MLPH
MLP	MLP
MLPs	MLP's
M. L. R.	MLR
MLR	MLR
MLSE	MLSE
M. L. S.	MLS
M.L.S.	MLS
MLS	MLS
MLT	MLT
MLW	MLW
MLWS	MLWS
MM&A	MM and A
M. M. J.	MMJ
MMK	MMK
MML	MML
M&M	M and M
M. M.	MM
M.M.	MM
MMSA	MMSA
M&M's	M and M's
M. M. S.	MMS
MMS	MMS
MMST	MMST
MMTB's	MMTB's
MMTS	MMTS
MMTV	MMTV
MMWR	MMWR
MMX	MMX
MNA	MNA
MNBA	MNBA
MNC	MNC
MNCPPC	MNCPPC
MNCs	MNC's
MNDM	MNDM
MNDNR	MNDNR
MNDO	MNDO
MNDR	MNDR
M&NF	M and NF
MNF	MNF
MNG	MNG
MNI	MNI
MNLA	MNLA
MNLA's	MNLA's
MNLF	MNLF
MNM	MNM
M. N.	MN
M.N.	MN
MNNA	MNNA
MNN	MNN
MNP	MNP
MNPP	MNPP
MNRG	MNRG
MNSD	MNSD
MNS	MNS
MNTC	MNTC
MNT	MNT
MNZM	MNZM
MNZ	MNZ
MOBKL	MOBKL
MOBK	MOBK
M.O.B.	MOB
M.O.D.	MOD
M.O.D.O.K.	MODOK
M.O.G.U.E.R.A.'s	MOGUERA's
M. O. H.	MOH
M. O.	MO
M.O.	MO
M.O.P.	MOP
M.O.R.	MOR
M.O.T.	MOT
MPAA	MPAA
MpA	MPA
MPA	MPA
MPAs	MPA's
MPB	MPB
MPBN	MPBN
MPBu	MPBU
MPCA	MPCA
MPCI	MPCI
MPC	MPC
MPD	MPD
MPE	MPE
MPF	MPF
MPG	MPG
M.P.H.	MPH
MPH	MPH
MP&I	MP and I
MPi	MPI
MPI	MPI
MPIO	MPIO
MPKAB	MPKAB
MPLAD	MPLAD
MPLA	MPLA
MPL	MPL
MPLMs	MPLM's
MPLR	MPLR
MPLS	MPLS
M&P	M and P
MPM	MPM
M. P.	MP
M.P.	MP
MPO	MPO
MPPJ	MPPJ
M.P.P.	MPP
MPP	MPP
MPPSC	MPPSC
MPPs	MPP's
MPQC	MPQC
MPR	MPR
MPRO	MPRO
MPRP	MPRP
MPRS	MPRS
MPSE	MPSE
MPSF	MPSF
M.P.'s	MP's
MP's	MP's
MPs	MP's
MPS	MPS
MPThe	MPTHE
MPT	MPT
Mpu	MPU
MPU	MPU
MPV	MPV
MPW	MPW
MPZ	MPZ
MQM	MQM
M. Q.	MQ
Mra	MRA
MRA	MRA
M. R. B.	MRB
MRB	MRB
MRBs	MRB's
MRCB	MRCB
MRCK	MRCK
MRCM	MRCM
MRC	MRC
M.R.C.S.	MRCS
MRCS	MRCS
MRDC	MRDC
MRD	MRD
mre	MRE
MRF	MRF
MR&LE	MR and LE
MRL	MRL
Mr.	mister
MRM	MRM
M. R.	MR
M.R.	MR
mRNA	MRNA
mRNAs	MRNA's
MRPGM	MRPGM
MRP	MRP
MRPS	MRPS
MRR	MRR
MRSA	MRSA
M.R.S.C.	MRSC
Mrs.	misses
MRSM	MRSM
MRT	MRT
MRTs	MRT's
MRTS	MRTS
MRTT	MRTT
MRU	MRU
MSAA	MSAA
MSAC	MSAC
MSAD	MSAD
MSA	MSA
M.S.A.S.	MSAS
MSAW	MSAW
MSB	MSB
MSBO	MSBO
MSBSD	MSBSD
MSCC	MSCC
M.S.C.	MSC
MSC	MSC
msd	MSD
MSD	MSD
MSDN	MSDN
MSDS	MSDS
Mse	MSE
MSFC	MSFC
M.S.F.	MSF
MSF	MSF
MSFT	MSFT
MSG	MSG
MSI	MSI
MSJ	MSJ
MSK	MSK
MSL	MSL
M&S	M and S
Ms.	miss
MSML	MSML
M.S.M.	MSM
MSM	MSM
M. S.	MS
M.S.	MS
MSNBC	MSNBC
MSNBC's	MSNBC's
MSN	MSN
MSOB	MSOB
MSOM	MSOM
M.S.P.	MSP
MSP	MSP
MSPs	MSP's
MSR	MSR
MSRP	MSRP
MSRTC	MSRTC
MSSH	MSSH
MSSK	MSSK
MSSMLP	MSSMLP
MSSM	MSSM
MSS	MSS
MSTA	MSTA
mst	MST
MST	MST
MSTS	MSTS
MSU's	MSU's
MSVCC	MSVCC
MSV	MSV
MSVU	MSVU
MSX	MSX
MSY	MSY
MSZP	MSZP
MTAC	MTAC
Mta	MTA
M.T.A.	MTA
MTA	MTA
MTA's	MTA's
MTAs	MTA's
MTBE	MTBE
MTBI	MTBI
MTB	MTB
MTC	MTC
MTDB	MTDB
M.T.D.	MTD
MTD	MTD
MTD's	MTD's
MTG	MTG
MTHFR	MTHFR
MTHL	MTHL
MTIC	MTIC
MTI	MTI
MTJ	MTJ
MTK	MTK
MTKO	MTKO
M&T	M and T
MTM	MTM
MTMR	MTMR
M. T.	MT
M.T.	MT
Mtor	MTOR
MTOSI	MTOSI
M.T.O.W.	MTOW
MTPA	MTPA
MTPC	MTPC
MTP	MTP
MTQ	MTQ
MTRCB	MTRCB
MTRC	MTRC
MTRJ	MTRJ
MTR	MTR
M. T. S.	MTS
MTS	MTS
MTSU	MTSU
MTTM	MTTM
MTT	MTT
MTU	MTU
MTV	MTV
MTVR	MTVR
MTV's	MTV's
mtvU	MTVU
MTVu	MTVU
MTVU	MTVU
MTY	MTY
MTZ	MTZ
MUKW	MUKW
M. U.	MU
MUSL	MUSL
M.U.s	MU's
M. U.S.	MUS
MVA	MVA
M. V. C.	MVC
M.V.C.	MVC
MVC	MVC
M. V. D.	MVD
MVD	MVD
MVH	MVH
MVK	MVK
M.V.M.	MVM
MVM	MVM
MVMs	MVM's
M. V.	MV
M.V.	MV
M.V.O.	MVO
MVO	MVO
MVP	MVP
MVPs	MVP's
MVPS	MVPS
M.V. P.T.	MVPT
MVs	MV's
MVS	MVS
MVSN	MVSN
MVSR	MVSR
MVT	MVT
MVV	MVV
M.W.A.M.	MWAM
MWA	MWA
MWC	MWC
MWe	MWE
M. W. E.	MWE
MWF	MWF
MWHL	MWHL
MWIFF	MWIFF
MWI	MWI
MWJCHL	MWJCHL
MWJHL	MWJHL
M. W. J.	MWJ
M. W.	MW
M.W.	MW
M. X.	MX
myb	MYB
myc	MYC
Myc	MYC
MYC	MYC
MYCN	MYCN
MyDD	MYDD
M. Y.	MY
M.Y.	MY
MySQL	MYSQL
MYSQL	MYSQL
MZC	MZC
MZH	MZH
MZM	MZM
M. Z.	MZ
MZP	MZP
MZT	MZT
NAACCR	NAACCR
NAACL	NAACL
NAAC	NAAC
N.A.A.C.P.	NAACP
NAACP	NAACP
NAACP's	NAACP's
N.A.C.L.	NACL
NAFBL	NAFBL
NAFC	NAFC
NAFC's	NAFC's
NAFH	NAFH
NAFI	NAFI
N. A.	NA
N.A.	NA
NBADL	NBADL
N.B.A.	NBA
NBA	NBA
N.B.A.'s	NBA's
NBA's	NBA's
NBAs	NBA's
NBCC	NBCC
NBC	NBC
NBC's	NBC's
NBCSN	NBCSN
NBDL	NBDL
NBD	NBD
NBFA's	NBFA's
NBF	NBF
NBG	NBG
NBI	NBI
NBK	NBK
NBL	NBL
N. B.	NB
N.B.	NB
N.B.N.	NBN
NBN	NBN
NBP	NBP
NBQ	NBQ
NBR	NBR
NBR's	NBR's
NBSK	NBSK
nbs	NBS
NBS	NBS
NBSP	NBSP
NBTE	NBTE
NBT	NBT
NBTwo	NBTWO
NBTY	NBTY
NBW	NBW
NCAAs	NCAA's
NCAM	NCAM
NCA	NCA
NCAP	NCAP
NCBC	NCBC
NCBI	NCBI
NCCC	NCCC
NCCF	NCCF
NCCMH	NCCMH
NCC	NCC
NCCP	NCCP
NCCs	NCC's
NCCS	NCCS
NCCU	NCCU
NCDC	NCDC
NCDD's	NCDD's
NCD	NCD
NCES	NCES
NCFA	NCFA
N.C.F.	NCF
NCF	NCF
NCG	NCG
NCGS	NCGS
NCHC	NCHC
NCH	NCH
NCHU	NCHU
NCID	NCID
NCI	NCI
NCIS	NCIS
NCIS's	NCIS's
NCKU	NCKU
NCLB	NCLB
NCLC	NCLC
NCL	NCL
NCLR	NCLR
NCLT	NCLT
NCMA	NCMA
NCMC	NCMC
NCMM	NCMM
NCM	NCM
NCMP	NCMP
NCNB	NCNB
N. C.	NC
N.C.	NC
N.C.O.	NCO
NCO	NCO
NCO's	NCO's
NCOs	NCO's
NCPA	NCPA
NCPC	NCPC
NCP	NCP
NCPO	NCPO
NCRC	NCRC
NCR	NCR
NCSU	NCSU
NCSY	NCSY
NCTA	NCTA
NCTC	NCTC
NCTE	NCTE
NCT	NCT
NCUA	NCUA
NCVO	NCVO
NCVS	NCVS
NCVT	NCVT
NCWM	NCWM
NCW	NCW
NDA	NDA
NDE	NDE
NDEP	NDEP
NDFB	NDFB
NDFT	NDFT
N.D.G.	NDG
N. D.	ND
N.D.	ND
N.D.N.Y.	NDNY
NDPH	NDPH
NDPK	NDPK
N.D.P.	NDP
NDP	NDP
NDP's	NDP's
NDRC	NDRC
NDRE	NDRE
NDRF	NDRF
N.E.A.R.	NEAR
NECW	NECW
N. E.	NE
N.E.	NE
N.E.R.D.	NERD
NERFU	NERFU
ner	NER
N.E.R.	NER
NER	NER
N.E.W.S.T.	NEWST
NFA	NFA
NFATc	NFATC
NFAT	NFAT
NFB	NFB
NFB's	NFB's
NFC	NFC
NFC's	NFC's
NFD	NFD
NFEA	NFEA
nfed	NFED
NFFC	NFFC
NFF	NFF
NFH	NFH
NFHS	NFHS
NFIB	NFIB
NFI	NFI
NFISD	NFISD
N.F.L.	NFL
NFL	NFL
NFLPA	NFLPA
NFL's	NFL's
N. F.	NF
N.F.	NF
NFO	NFO
NFPA	NFPA
NFPF	NFPF
NFP	NFP
NFPW	NFPW
NFRS	NFRS
NFS	NFS
NGC	NGC
Nge	NGE
NGF	NGF
N.G.L.	NGL
N. G.	NG
N.G.	NG
NGO	NGO
NGO's	NGO's
NGOs	NGO's
NGRC	NGRC
N.G.R.	NGR
NGR	NGR
NGRR	NGRR
NGS	NGS
NGSS	NGSS
NGST	NGST
NGTC	NGTC
Nha	NHA
NHA	NHA
NHCEs	NHCE's
NHC	NHC
NHCP	NHCP
NHCs	NHC's
NHD	NHD
NHHD	NHHD
NHHI	NHHI
nhi	NHI
NHI	NHI
NHK	NHK
NHK's	NHK's
N.H.L.	NHL
NHM&W	NHM and W
N. H.	NH
N.H.	NH
NHP	NHP
NHPs	NHP's
NHPS	NHPS
NHRA	NHRA
NHRC	NHRC
NHSCT	NHSCT
NHS	NHS
NHST	NHST
NHW	NHW
N.I.B.B.L.E.	NIBBLE
NIBC	NIBC
NIBR	NIBR
N. I.	NI
N.I.	NI
N'I	NI
N.J.A.C.	NJAC
N. J. A.	NJA
NJA	NJA
N. J. C.	NJC
NJC	NJC
NJIT	NJIT
N. J. M.	NJM
NJM	NJM
N. J.	NJ
N.J.	NJ
NJN	NJN
Njoo	NJOO
NJPS	NJPS
NJPW	NJPW
N.J.S.A.	NJSA
N.J.'s	NJ's
NKL	NKL
N. K.	NK
N.K.	NK
N. K. N.	NKN
NKP	NKP
NKP's	NKP's
NKR	NKR
NKT	NKT
NKU	NKU
nkvd	NKVD
NKVD	NKVD
NKVM	NKVM
nkv	NKV
NKX	NKX
NLAES	NLAES
NLAI	NLAI
NLA	NLA
NLB	NLB
NLCF	NLCF
NLC	NLC
NLCS	NLCS
NLDC	NLDC
NLD	NLD
NLD's	NLD's
NLDS	NLDS
N. L.	NL
N.L.	NL
NLP	NLP
NLRB	NLRB
NLRP	NLRP
NLRs	NLR's
NLW	NLW
NLX	NLX
NMAA	NMAA
NMA	NMA
NMBS	NMBS
NMBU	NMBU
NMCA	NMCA
NMCB	NMCB
NMC	NMC
N. M.	NM
N.M.	NM
NMP	NMP
NMR	NMR
NMRW	NMRW
NMT	NMT
NMU	NMU
NMV	NMV
NMW	NMW
NNCL	NNCL
NNFL	NNFL
NNF	NNF
N. N.	NN
N.N.	NN
NNSA	NNSA
NNSS	NNSS
NNSU	NNSU
NNSW	NNSW
N.O.R.	NOR
NPA	NPA
NPBD	NPBD
NPBL	NPBL
NPB	NPB
NPC	NPC
NPCs	NPC's
NPDC	NPDC
NPD	NPD
NPF	NPF
NPF's	NPF's
NPGL	NPGL
NPG	NPG
NPGS	NPGS
NPH	NPH
NPHS	NPHS
NPIM	NPIM
NPI	NPI
NPJ	NPJ
NPK	NPK
NPL	NPL
NPMA	NPMA
NPM	NPM
NPMs	NPM's
N. P.	NP
N.P.	NP
NP	NP
NPO	NPO
NPP	NPP
NPP's	NPP's
NPRL	NPRL
NPRN	NPRN
NPR	NPR
NPRR	NPRR
NPR's	NPR's
NPRSO	NPRSO
NPSC	NPSC
NPSG	NPSG
NPSL	NPSL
NP's	NP's
NPs	NP's
NPS	NPS
NPTI	NPTI
NPT	NPT
NPV	NPV
NPWE	NPWE
NPWS	NPWS
NPY	NPY
NQAI	NQAI
NQEA	NQEA
NQHS	NQHS
N. Q.	NQ
nri	NRI
Nri	NRI
NRI	NRI
NRIs	NRI's
NRJ	NRJ
NRJs	NRJ's
NRK	NRK
NRLA	NRLA
NRL	NRL
NRL's	NRL's
NRMA	NRMA
NRM	NRM
NRN	NRN
nr	NR
N. R.	NR
N.R.	NR
N.R.A.	NRA
NSA	NSA
NSAP	NSAP
NSA's	NSA's
NSB	NSB
NSC	NSC
NSD	NSD
NSE	NSE
NSFE	NSFE
NSF	NSF
NSFW	NSFW
NSG	NSG
NSI	NSI
NSL	NSL
NSM	NSM
NSN	NSN
N. S.	NS
N.S.	NS
NSO	NSO
NSOs	NSO's
NSPCC	NSPCC
NSPC	NSPC
NSP	NSP
NSRI	NSRI
NSRL	NSRL
NSR	NSR
NSSCD	NSSCD
NSSDC	NSSDC
NSS	NSS
NSTA	NSTA
NST	NST
NSU	NSU
NSV	NSV
NSVT	NSVT
NSWBLF	NSWBLF
NSWC	NSWC
NSWCV	NSWCV
NSWEC	NSWEC
NSWGR	NSWGR
N.S.W.	NSW
NSW	NSW
Nta	NTA
NTA	NTA
NTA's	NTA's
ntb	NTB
NTB	NTB
NTC	NTC
NTD	NTD
NTFL	NTFL
NTF	NTF
NTI	NTI
NTKF	NTKF
NTL	NTL
N. T.	NT
N.T.	NT
NTR	NTR
NTR's	NTR's
NTSB	NTSB
NTSB's	NTSB's
NTSC	NTSC
NTS	NTS
NTTF	NTTF
NTT	NTT
NTTR	NTTR
NTUC	NTUC
NTU	NTU
NTVB	NTVB
NTV	NTV
ntw	NTW
N.U.	NU
NVA	NVA
NVAO	NVAO
NVC	NVC
NVDA	NVDA
NvDA's	NVDA's
NVFC	NVFC
NVGOP	NVGOP
NVHJ's	NVHJ's
NVH	NVH
NVI	NVI
NVL	NVL
N. V.	NV
N.V.	NV
NWAFU	NWAFU
nwa	NWA
N.W.A.	NWA
NWA	NWA
NWA's	NWA's
N.W.F.P.	NWFP
NWFP	NWFP
NWMP	NWMP
N&W	N and W
NWN	NWN
N. W.	NW
N.W.	NW
NWPD	NWPD
N.W.P.	NWP
NWP	NWP
NWS	NWS
N.W.T.	NWT
NWT	NWT
nyc	NYC
N.Y.C.	NYC
NYC	NYC
NYC's	NYC's
N.Y. G.O.P.	NYGOP
N.Y.L.	NYL
N. Y.	NY
N.Y.	NY
N.Y.P.D.	NYPD
NYPD	NYPD
NYPD's	NYPD's
NYPL	NYPL
N.Y.P.	NYP
NY's	NY's
N.Y.S.	NYS
N.Y.S.V.	NYSV
N.Y.U.	NYU
NYU	NYU
NYU's	NYU's
NYYC	NYYC
NZAID	NZAID
NZAOD	NZAOD
NZCA	NZCA
NZDT	NZDT
NZEF	NZEF
NZETC	NZETC
NZFC	NZFC
NZF	NZF
N'Zif	NZIF
NZiK	NZIK
N'Zi	NZI
NZIV	NZIV
NZL	NZL
NZLP	NZLP
N.Z.	NZ
NZPA	NZPA
NZSAS	NZSAS
NZ's	NZ's
NZS	NZS
NZTA	NZTA
N.Z.W.P.W.	NZWPW
O.A.C.	OAC
O. A.	OA
O.A.	OA
O.A.R.	OAR
O.A.S.	OAS
O.B.E.	OBE
obl	OBL
Oblt	OBLT
O.B.	OB
O. C.	OC
O.C.	OC
Octl	OCTL
O.C.T.	OCT
O. D.	OD
O.E.	OE
O.F.M.	OFM
O.F.	OF
ofr	OFR
O.F.R.	OFR
OFR	OFR
O.F.T.B.	OFTB
OGL	OGL
O&G	O and G
O. G.	OG
O.G.	OG
O.G.S.	OGS
OGS	OGS
O.H.A.	OHA
O. H.	OH
O.H.	OH
OHV	OHV
O. I.	OI
O.I.	OI
O. J.	OJ
O.J.	OJ
OJ	OJ
OJSC	OJSC
OKBM	OKBM
OKB	OKB
OKC	OKC
OK'd	OKD
OKd	OKD
OKD	OKD
oke	OKE
Oke	OKE
OKH	OKH
O.K.I.	OKI
OKK	OKK
OKM	OKM
O&K	O and K
O. K.	OK
O.K.	OK
O.L.F.A.L.	OLFAL
O. L. K.	OLK
O. L.	OL
O.L.	OL
Olo	OLO
Olov	OLOV
OLPC	OLPC
OLPH	OLPH
ols	OLS
OLs	OL's
OLS	OLS
OLSR	OLSR
OLTL	OLTL
OLVT	OLVT
olvwm	OLVWM
olwm	OLWM
OMB	OMB
OMC	OMC
OMCS	OMCS
OMD	OMD
O&MFL	O and MFL
OMF	OMF
omg	OMG
OMG	OMG
OMGs	OMG's
O. M.	OM
O.M.	OM
OmOm	OMOM
Om's	OM's
OMTP	OMTP
OMVG	OMVG
OMW	OMW
OMX	OMX
ONCHR	ONCHR
ONC	ONC
oncu	ONCU
ONDH	ONDH
ond	OND
onf	ONF
ONF	ONF
ONGC	ONGC
ONIR	ONIR
ONJSC	ONJSC
ONM	ONM
ONMR	ONMR
O. N.	ON
O.N.	ON
O&O	O and O
OOOA	OOOA
O. O.	OO
O.O.	OO
OO	OO
OOO's	OOO's
Oop	OOP
OOP	OOP
OOPSLA	OOPSLA
oor	OOR
oose	OOSE
Oo's	OO's
OOTP	OOTP
Ootw	OOTW
OOUR	OOUR
OPAC	OPAC
OPAG	OPAG
O.P.A.	OPA
OPBF	OPBF
OPB	OPB
OPC	OPC
OPCS	OPCS
OPCW	OPCW
OPD	OPD
O.P.I.	OPI
OPIRG	OPIRG
OPJHL	OPJHL
OPLC	OPLC
OPL	OPL
OPMB	OPMB
OPM	OPM
OPMs	OPM's
OPN	OPN
O. P.	OP
O.P.	OP
opr	OPR
Opr	OPR
OPR	OPR
O.R.C.	ORC
ORECA	ORECA
ORFs	ORF's
ORMO	ORMO
ORNL	ORNL
OR&N	OR and N
O. R.	OR
osaa	OSAA
OSAA	OSAA
osa	OSA
Osa	OSA
O.S.A.	OSA
OSA	OSA
O.S.B.	OSB
OSB	OSB
OSBs	OSB's
O.S.N.	OSN
OSN	OSN
O. S.	OS
O.S.	OS
OSP	OSP
OSR	OSR
OSTM	OSTM
O.S.T.	OST
OSTP	OSTP
OSTs	OST's
osv	OSV
OSV	OSV
OTB	OTB
OTC	OTC
OTJ	OTJ
OTL	OTL
OTMH	OTMH
OTO	OTO
O.T.	OT
OTP	OTP
OTR	OTR
OTs	OT's
OTS	OTS
Otu	OTU
OTU	OTU
otv	OTV
O.U.	OU
OU	OU
OUP	OUP
OUSA	OUSA
OVA's	OVA's
ovca	OVCA
Ovca	OVCA
OVC	OVC
OVC's	OVC's
Ovda	OVDA
OVF	OVF
OVM	OVM
Ovo	OVO
OVO	OVO
ov	OV
Ov	OV
O. V.	OV
O.V.	OV
OV	OV
OVP	OVP
OVS	OVS
OVT	OVT
OVW	OVW
O.W.A.	OWA
OWBT	OWBT
OWCs	OWC's
OWGR	OWGR
OWHA's	OWHA's
OWIU	OWIU
OWM	OWM
O. W.	OW
O.W.	OW
P. A. C.	PAC
P. A. J.	PAJ
P.A.J.	PAJ
P. A. M.	PAM
P.A.M.	PAM
pa	PA
P. A.	PA
P.A.	PA
PA	PA
PAQ	PAQ
P.A.R.	PAR
P. A. S.	PAS
PBAA	PBAA
PBA	PBA
PBA's	PBA's
PBB	PBB
PBCC	PBCC
pBCE	PBCE
pbc	PBC
P.B.C.	PBC
PBF	PBF
PBG	PBG
PBIL	PBIL
PBI	PBI
PBK	PBK
PBL	PBL
PBM	PBM
PBMR	PBMR
PBO	PBO
pb	PB
P. B.	PB
P.B.	PB
PB	PB
PBP	PBP
PBR	PBR
PBS	PBS
PBT	PBT
PBX	PBX
PBY	PBY
P. C. A.	PCA
PCA	PCA
PCB	PCB
PCB's	PCB's
PCBs	PCB's
PCBS	PCBS
PCC	PCC
PCCS	PCCS
PCCW	PCCW
PCCW's	PCCW's
PCDDs	PCDD's
PCDHB	PCDHB
PCDH	PCDH
PCD	PCD
PCE	PCE
PCeU	PCEU
PCFCL	PCFCL
PCFL	PCFL
PCF	PCF
PCFS	PCFS
PCG	PCG
PCGS	PCGS
PCHA	PCHA
PCHA's	PCHA's
P.C.H.	PCH
PCH	PCH
PCHR	PCHR
PCIe	PCIE
pci	PCI
PCI	PCI
PCJHL	PCJHL
P. C. J.	PCJ
PCJ	PCJ
PCK	PCK
PCLM	PCLM
pcl	PCL
PCL	PCL
PCMCIA	PCMCIA
PCMNO	PCMNO
PCM	PCM
PCMS	PCMS
PCNA	PCNA
PCN	PCN
PcoA	PCOA
PCOE	PCOE
PCO	PCO
pc	PC
P. C.	PC
P.C.	PC
PC	PC
PCPFL	PCPFL
PCP	PCP
PCPV	PCPV
PCRC	PCRC
PCRE	PCRE
PCRev	PCREV
PCRM	PCRM
PCR	PCR
PCSK	PCSK
PCSOM	PCSOM
pcs	PCS
P.C.s	PC's
PC's	PC's
PCTL	PCTL
PCT	PCT
PCTV	PCTV
PCU	PCU
PCU's	PCU's
PCW	PCW
PCX	PCX
pDAB	PDAB
PDAB	PDAB
PDA	PDA
PDAs	PDA's
PDBML	PDBML
PDB	PDB
pdbp	PDBP
PDBsum	PDBSUM
PDCI	PDCI
PDC	PDC
PDCPD	PDCPD
PDC's	PDC's
PDCs	PDC's
PD&D	PD and D
PDD	PDD
PDE	PDE
PDEs	PDE's
PDES	PDES
pdf	PDF
PDF	PDF
PDFs	PDF's
PDFT	PDFT
PDGF	PDGF
PDG	PDG
PDHJ	PDHJ
PDH	PDH
PDI	PDI
PDJ	PDJ
PDK	PDK
PDL	PDL
PDN	PDN
PDO	PDO
P&D	P and D
P. D.	PD
P.D.	PD
PD	PD
PDP	PDP
PDP's	PDP's
PDPs	PDP's
P. D. Q.	PDQ
PDR	PDR
PDSA	PDSA
PDSI	PDSI
PD's	PD's
PDs	PD's
P.D.S.	PDS
PDS	PDS
PDSP	PDSP
PDT	PDT
P.E.I.	PEI
P.E.I.'s	PEI's
P.E.N.	PEN
P. E.	PE
P.E.	PE
P.F.L.	PFL
PF's	PF's
PFs	PF's
PFS	PFS
PFU	PFU
PFV	PFV
PFW&C	PFW and C
P.G.A.	PGA
PGA	PGA
PGM	PGM
PGMs	PGM's
PG&N	PG and N
P&G	P and G
P. G.	PG
P.G.	PG
P.G.T.	PGT
PHD	PHD
P. H. G.	PHG
PHH	PHH
PHHS	PHHS
PHLF	PHLF
Phlo	PHLO
PHL	PHL
PHN	PHN
P&H	P and H
P. H.	PH
P.H.	PH
php	PHP
PHP	PHP
PHPs	PHP's
P.I.D.E.	PIDE
P&I	P and I
P. I.	PI
P.I.	PI
P. I. W.	PIW
Piz	PIZ
PJB	PJB
PJC	PJC
PJD	PJD
P. J. F.	PJF
P.J.K.	PJK
pj	PJ
P. J.	PJ
P.J.	PJ
PJ	PJ
PJ's	PJ's
PJs	PJ's
P.J.T.	PJT
P. K.	PK
P.K.	PK
PK	PK
PLCC	PLCC
plc	PLC
PLC	PLC
PLC's	PLC's
PLCs	PLC's
P.L.O.	PLO
P. L.	PL
P.L.	PL
PLP	PLP
PLX	PLX
P. M. A.	PMA
PMC	PMC
PMG	PMG
PML	PML
PMLP	PMLP
PMMA	PMMA
PMMoV	PMMOV
PMM	PMM
PMMS	PMMS
PMMT	PMMT
PMOI	PMOI
PMO	PMO
PMPC	PMPC
PMPF	PMPF
p.m.	PM
p.m	PM
P. M.	PM
P.M.	PM
PM	PM
PMP	PMP
PMP's	PMP's
PMRN	PMRN
PMRO	PMRO
PMR	PMR
PMRR	PMRR
PMSE	PMSE
PMSL	PMSL
PMSM	PMSM
PM's	PM's
PMs	PM's
P. M. S.	PMS
PMS	PMS
PMSSY	PMSSY
PMT	PMT
PMVY	PMVY
PMWA	PMWA
PNaCl	PNACL
pna	PNA
PNA	PNA
Pnau	PNAU
pnb	PNB
PNB	PNB
PNC	PNC
PNE	PNE
PNE's	PNE's
PNEs	PNE's
PNETs	PNET's
pneus	PNEUS
PNFA	PNFA
PNF	PNF
PNGIA	PNGIA
png	PNG
PNG	PNG
PNH	PNH
PNI	PNI
PNL	PNL
PNL's	PNL's
PNMT	PNMT
PNNL	PNNL
PNNs	PNN's
PNoy	PNOY
pn	PN
P. N.	PN
P.N.	PN
PN	PN
PNP	PNP
P.N.R.A.	PNRA
P.O.D.	POD
P.O.D.'s	POD's
P&O	P and O
P. O.	PO
P.O.	PO
P.O.S.	POS
P.O.V.	POV
P.O.W.	POW
P.O.W.'s	POW's
PPACA	PPACA
PPA	PPA
PPBS	PPBS
PPC	PPC
PPD	PPD
PPE	PPE
PPF	PPF
PPG	PPG
P&PH	P and PH
PPH	PPH
PPi	PPI
P.P.I.	PPI
PPI	PPI
PPJ	PPJ
PPKM	PPKM
PPK	PPK
PPL	PPL
PPM	PPM
PPNB	PPNB
PPN	PPN
PPO	PPO
P. P.	PP
P.P.	PP
PPRP	PPRP
PPR	PPR
PP's	PP's
PPS	PPS
PPT	PPT
PPTV	PPTV
PPV	PPV
PPVs	PPV's
PPy	PPY
PQDT	PQDT
PQ	PQ
PQQ	PQQ
PQ's	PQ's
PQS	PQS
PRB	PRB
PRCA	PRCA
PRC	PRC
PRCS	PRCS
PRDM	PRDM
PRD	PRD
PRD's	PRD's
P.R.I.M.E.	PRIME
pr	PR
P. R.	PR
P.R.	PR
PR	PR
P.S.A.	PSA
P.S.C.	PSC
P.S.K.	PSK
PSP	PSP
P. s	P's
P.'s	P's
Ps	P's
P. S.	PS
P.S.	PS
PSQL	PSQL
PSR	PSR
PSRU	PSRU
PSSA	PSSA
PSSA's	PSSA's
PSSAs	PSSA's
PSSI	PSSI
PSS	PSS
PSS's	PSS's
PST	PST
PSU	PSU
PSV	PSV
PSW	PSW
pTA	PTA
PTA	PTA
PTA's	PTA's
PTAs	PTA's
PTB	PTB
PTBT	PTBT
PTCH	PTCH
PTC	PTC
Pte	PTE
PTEs	PTE's
PTFE	PTFE
ptf	PTF
PTF	PTF
PTH	PTH
Ptie	PTIE
PTI	PTI
PTI's	PTI's
PTK	PTK
PTLLS	PTLLS
PTL	PTL
PTLs	PTL's
PTNNT	PTNNT
Ptol	PTOL
PTO	PTO
PTPN	PTPN
PTP	PTP
pt	PT
P. T.	PT
P.T.	PT
PT	PT
PTSD	PTSD
PTSE	PTSE
PTS	PTS
PTTGC	PTTGC
PTTG	PTTG
PTTOW	PTTOW
PTT	PTT
PTTs	PTT's
PTUN	PTUN
PTV	PTV
PTV's	PTV's
P'Twa	PTWA
PTY	PTY
P.U.F.	PUF
Puiu	PUIU
PUKKE	PUKKE
PUK	PUK
Pul	PUL
P. U. M.	PUM
PVA	PVA
PVAs	PVA's
PVB	PVB
P.V.C.	PVC
PVC	PVC
PvdA	PVDA
PVEM	PVEM
pve	PVE
PVH	PVH
P.V.L.	PVL
PVL	PVL
PVN	PVN
PVO	PVO
PVP	PVP
P. V.	PV
P.V.	PV
PV	PV
pvr	PVR
PVR	PVR
PVRS	PVRS
PVs	PV's
PVS	PVS
PVU	PVU
PWA	PWA
PWB	PWB
PWC	PWC
PWD	PWD
PWF	PWF
P. W. G.	PWG
P.W.G.	PWG
PWG	PWG
PWI	PWI
pwll	PWLL
PWM	PWM
P.W.O.	PWO
P&W	P and W
P. W.	PW
P.W.	PW
PW	PW
Pyi	PYI
PYI	PYI
Pyk	PYK
PYK	PYK
Pyl	PYL
PyL	PYL
PYP	PYP
P. Y.	PY
Pyu	PYU
Pyw	PYW
Pyx	PYX
PZB	PZB
PZL	PZL
PZP	PZP
P. Z.	PZ
Q. A. P.	QAP
QAP	QAP
Q. A.	QA
QA	QA
Q&A	Q and A
Q&A's	Q and A's
Q&As	Q and A's
QbA	QBA
QBE	QBE
QBH	QBH
QBL	QBL
Q.B.	QB
QB	QB
Q.C.B.	QCB
QCD	QCD
Q.C.	QC
QD	QD
QDS	QDS
QEA	QEA
QEC	QEC
Q.E.D.	QED
QED	QED
Q.E.H.	QEH
Q. E.	QE
Q.H.C.	QHC
QHP	QHP
Q.H.	QH
Q.I.	QI
Q. J.	QJ
QJ	QJ
Q. J. R.	QJR
Q. N.	QN
QPF	QPF
QPFS	QPFS
QPM	QPM
QPO	QPO
QPOs	QPO's
QPP	QPP
QP	QP
Q.P.R.	QPR
QPR	QPR
QQ	QQ
QRL	QRL
QRL's	QRL's
QRNA	QRNA
QROPS	QROPS
QRP	QRP
QR	QR
QRS	QRS
QRT	QRT
QRV	QRV
QSAR	QSAR
QSES	QSES
QSI	QSI
QSL	QSL
QSM	QSM
QSO	QSO
QST	QST
QSY	QSY
QVC	QVC
QVD	QVD
QVM	QVM
Q.V.	QV
R.A.B.	RAB
R. A. E.	RAE
R.A.F.	RAF
R.A.J.	RAJ
R. A.	RA
R.A.	RA
R&A	R and A
RAV	RAV
R&AW	R and AW
RAZR	RAZR
RBAC	RBAC
RbAg	RBAG
RBA	RBA
RBBP	RBBP
RBC	RBC
RBCs	RBC's
RBD	RBD
RBE	RBE
RBGE	RBGE
RBG	RBG
RBI	RBI
RBIs	RBI's
R. B. J.	RBJ
R.B.J.	RBJ
RBK	RBK
R.B.L.	RBL
RBL	RBL
RBMG	RBMG
RBMG's	RBMG's
RBM	RBM
RBMY	RBMY
RBO	RBO
RBP	RBP
R&B	R and B
R. B.	RB
R.B.	RB
RBR	RBR
RBS	RBS
RBTCO's	RBTCO's
RBTH	RBTH
RBWH	RBWH
RBW	RBW
RBX	RBX
RBZ	RBZ
RCAC	RCAC
RCAF	RCAF
rca	RCA
R.C.A.	RCA
RCA	RCA
RCA's	RCA's
RCBC	RCBC
RCB	RCB
RCCA	RCCA
RCCD	RCCD
RCCL	RCCL
RCCM	RCCM
RCC	RCC
RCI	RCI
R. C. K.	RCK
RCL	RCL
R.C.M.	RCM
RCM	RCM
RCN	RCN
RCPO	RCPO
RCP	RCP
RCPT	RCPT
R&C	R and C
rc	RC
R. C.	RC
R.C.	RC
RCRD	RCRD
RCR	RCR
RCSB	RCSB
RCS	RCS
RCT	RCT
RCTs	RCT's
RCTS	RCTS
RCTV	RCTV
RCV	RCV
RCW	RCW
RDB	RDB
RDC	RDC
RDD	RDD
RdE	RDE
RDFC	RDFC
RDF	RDF
R.D.G.	RDG
R&D	R and D
R. D.	RD
R.D.	RD
R.E.A.	REA
R. E. B.	REB
R.E.D.	RED
R.E.L.	REL
R.E.M.	REM
R.E.M.'s	REM's
R.E.O.	REO
REPL	REPL
REPLs	REPL's
R.E.P.	REP
R. E.	RE
R.E.	RE
R.E.R.	RER
R.F.A.	RFA
R.F.C.	RFC
R. F.	RF
R.F.	RF
R. F.S.	RFS
R.F.W.	RFW
RFW	RFW
RFX	RFX
RGB	RGB
RGD	RGD
RGF	RGF
RGG	RGG
RGI	RGI
RGK	RGK
RGMA	RGMA
RGNL	RGNL
RGPH	RGPH
R&G	R and G
R. G.	RG
R.G.	RG
RGR	RGR
RGS	RGS
RGS's	RGS's
RGTP	RGTP
RGU	RGU
RGV	RGV
RGX	RGX
R. H. C.	RHC
RHC	RHC
RHD	RHD
RHHF	RHHF
RHH	RHH
RHHS	RHHS
RHIBs	RHIB's
RHIC	RHIC
RHI	RHI
Rhiw	RHIW
RHK	RHK
rhl	RHL
RHM	RHM
RhoG	RHOG
Rho's	RHO's
RHP	RHP
R. H.	RH
R.H.	RH
R.H.S.J.	RHSJ
R. I. C.	RIC
R.I.C.	RIC
R. I. P.	RIP
R.I.P.	RIP
R&I	R and I
R. I.	RI
R.I.	RI
riu	RIU
Riu	RIU
rivs	RIVS
Rivu	RIVU
RIXS	RIXS
Rixt	RIXT
RJB	RJB
RJD	RJD
RJE	RJE
rjf	RJF
RJHS	RJHS
R. J. J.	RJJ
RJJ	RJJ
RJL	RJL
RJN	RJN
R. J.	RJ
R.J.	RJ
RJ	RJ
RJR	RJR
RJ's	RJ's
RJTD	RJTD
R. K. B.	RKB
RKD	RKD
RKI	RKI
RKKA	RKKA
RKL	RKL
R.K.O.	RKO
RKO	RKO
RKO's	RKO's
R. K.	RK
R.K.	RK
RLM	RLM
RLM's	RLM's
R. L.	RL
R.L.	RL
RL	RL
RLV	RLV
rly	RLY
RMAF	RMAF
RMAG	RMAG
RMA	RMA
RMB	RMB
RMCH	RMCH
RMCL	RMCL
R.M.C.	RMC
RMC	RMC
RMDs	RMD's
R.M.E.S.	RMES
RMFL	RMFL
R.M.F.	RMF
RMF	RMF
RMG	RMG
R. M. H.	RMH
RMI	RMI
RMIT	RMIT
RMIT's	RMIT's
RMJM	RMJM
R.M.K.	RMK
RMK	RMK
R. M. L.	RML
RML	RML
RMLs	RML's
RMM	RMM
RMP	RMP
rm	RM
R. M.	RM
R.M.	RM
RM	RM
RMR	RMR
RMRS	RMRS
RMSD	RMSD
RMSDs	RMSD's
RMSE	RMSE
RMs	RM's
RMS	RMS
R. M. W.	RMW
R.M.W.	RMW
RMW	RMW
RMX	RMX
RNAO	RNAO
rna	RNA
RNA	RNA
RNA's	RNA's
RNAs	RNA's
RNAS	RNAS
RNC	RNC
RND	RND
RNE	RNE
Rnet	RNET
RNF	RNF
RNG	RNG
Rnic	RNIC
RNJD	RNJD
RNK	RNK
RNLAF	RNLAF
RNLI	RNLI
RNLI's	RNLI's
RNNs	RNN's
RNOH	RNOH
RNP	RNP
RNPs	RNP's
RNPS	RNPS
R. N.	RN
R.N.	RN
RN	RN
R.N.R.	RNR
RNZ	RNZ
R.O.C.K.	ROCK
R.O.C.	ROC
ROKMC	ROKMC
ROKN	ROKN
rOmpB	ROMPB
Rooi	ROOI
ROP	ROP
R. O.	RO
R.O.	RO
ROVs	ROV's
Roxb	ROXB
Roxx	ROXX
RPA	RPA
RPAYC	RPAYC
RPB	RPB
RP&C	RP and C
rpc	RPC
RPC	RPC
Rpe	RPE
RPE	RPE
RPF	RPF
RPGA	RPGA
rpg	RPG
RPG	RPG
RPG's	RPG's
RPGs	RPG's
RPI	RPI
RPI's	RPI's
RPK	RPK
RPL	RPL
rpm	RPM
RPM	RPM
RPMS	RPMS
RPO	RPO
RPP	RPP
R. P.	RP
R.P.	RP
RP	RP
RPs	RP's
R.P.S.	RPS
RPS	RPS
RPT	RPT
RPVE	RPVE
RPV	RPV
R. Q.	RQ
R.Q.	RQ
RQW	RQW
rra	RRA
RRA	RRA
RRC	RRC
RRDE	RRDE
rrd	RRD
Rreli	RRELI
rre	RRE
RRE	RRE
RRG	RRG
R. R. H.	RRH
RRH	RRH
RRKM	RRKM
R.R.K.	RRK
rRNA	RRNA
rRNAs	RRNA's
RRN	RRN
RRP	RRP
R&R	R and R
rr	RR
R. R.	RR
R.R.	RR
RR	RR
RRR	RRR
RRSR	RRSR
RRS	RRS
RSAF	RSAF
R. S. A.	RSA
RSA	RSA
RSCG	RSCG
RSCJ	RSCJ
R.S.C.	RSC
RSC	RSC
RSCS	RSCS
RSD	RSD
RSE	RSE
RSF	RSF
RSFSR	RSFSR
RSG	RSG
RSHA	RSHA
rsh	RSH
RSHS	RSHS
RSICC	RSICC
RSID	RSID
RSI	RSI
Rsis	RSI's
RSI's	RSI's
RSIS	RSIS
RSK	RSK
RSL	RSL
rsly	RSLY
RsmA	RSMA
RSMC	RSMC
RSMI	RSMI
RSML	RSML
RSM	RSM
RSM's	RSM's
RSNO	RSNO
RSN	RSN
RSNZ	RSNZ
R. S. O.	RSO
RSO	RSO
RSPB	RSPB
RSPCA	RSPCA
RSpec	RSPEC
RSPK	RSPK
RSPO	RSPO
R. S. P.	RSP
RSP	RSP
RSR	RSR
rs	RS
Rs	R's
R. S.	RS
R.S.	RS
RS	RS
RSSI	RSSI
R. S. S.	RSS
RSS	RSS
RSSSF	RSSSF
RSTC	RSTC
RST	RST
RSu	RSU
R.S.U.	RSU
RSU	RSU
RSU's	RSU's
RSVP	RSVP
RSV	RSV
RSX	RSX
RTAFB	RTAFB
RTA	RTA
RTBF	RTBF
rtb	RTB
RTB	RTB
RTCG's	RTCG's
RTC	RTC
RTCs	RTC's
RTD	RTD
RTEC	RTEC
RTEjr	RTEJR
RTeOR	RTEOR
RTE	RTE
RTE's	RTE's
RTFB	RTFB
RTFM	RTFM
RTF	RTF
RTF's	RTF's
RTFS	RTFS
RTHK	RTHK
RTHK's	RTHK's
RTHL	RTHL
RTIP	RTIP
RTI	RTI
RTKL	RTKL
RTK	RTK
RTLM	RTLM
RTL	RTL
RTL's	RTL's
RTML	RTML
RTMP	RTMP
RTM	RTM
RTN	RTN
RTO	RTO
RTOs	RTO's
RTOS	RTOS
rtPA	RTPA
RTP	RTP
RTR	RTR
rt	RT
R. T.	RT
R.T.	RT
RT	RT
rts	RTS
RTS	RTS
RTS's	RTS's
RTTOV	RTTOV
RTT	RTT
RTTY	RTTY
RTUK	RTUK
RTU	RTU
RTVC	RTVC
RTVE	RTVE
RTVFBiH	RTVFBIH
RTV	RTV
RTVV	RTVV
RTW	RTW
RTXC	RTXC
RTX	RTX
RTZ	RTZ
Ruao	RUAO
RUC	RUC
RUC's	RUC's
RUFC	RUFC
Rukn	RUKN
Ruk	RUK
RUMC	RUMC
RUNX	RUNX
Rupf	RUPF
Rupr	RUPR
rup	RUP
Rup	RUP
RUP	RUP
R.U.R.	RUR
RUR	RUR
R. U.	RU
R.U.	RU
RU	RU
RUSD	RUSD
RutB	RUTB
Ruu	RUU
RUV	RUV
Ruwa	RUWA
Ruy	RUY
Ruyt	RUYT
RVAR	RVAR
Rvat	RVAT
RVC	RVC
RVCT	RVCT
RVD	RVD
R. V. E.	RVE
RVE	RVE
RVGK	RVGK
R.V.G.	RVG
R. V. J.	RVJ
R.V.J.	RVJ
RVM	RVM
RVNG	RVNG
Rvo	RVO
RVO	RVO
RVR	RVR
R. V.	RV
R.V.	RV
RV	RV
rvs	RVS
RVTD's	RVTD's
RVU	RVU
rwa	RWA
Rwa	RWA
RWA	RWA
rwb	RWB
RWB	RWB
RWC	RWC
RWD	RWD
RWDSU	RWDSU
RWE	RWE
RWEs	RWE's
RWFC	RWFC
RWIS	RWIS
rwjf	RWJF
R.W.R.J.	RWRJ
R. W.	RW
R.W.	RW
RW	RW
RWSL	RWSL
R. W. S.	RWS
RWS	RWS
Rxa	RXA
RXL	RXL
RX	RX
RZR	RZR
rz	RZ
R. Z.	RZ
RZ	RZ
RZS	RZS
S.A.B.	SAB
S.A.D.	SAD
SAIC	SAIC
Sa'id	SAID
S.A.I.	SAI
SAIT's	SAIT's
SAKEC	SAKEC
S. A. L.	SAL
S.A.P.A.	SAPA
S.A.P.I.	SAPI
S. A. R.	SAR
S.A.R.	SAR
S. A.	SA
S.A.	SA
SA	SA
S.A.S.	SAS
SAS	SAS
S.A.V.A.	SAVA
Saxl	SAXL
Sa'yo	SAYO
SAZU	SAZU
SBAC's	SBAC's
Sbai	SBAI
S.B.A.	SBA
SBA	SBA
SBBK	SBBK
SBB	SBB
SBCM	SBCM
SBCMT	SBCMT
sbc	SBC
SBC	SBC
SBCs	SBC's
SBDE	SBDE
SBD	SBD
SBE	SBE
SBF	SBF
SBI	SBI
SBKP	SBKP
sbk	SBK
SBK	SBK
SBL	SBL
SBML	SBML
SBMNH	SBMNH
SBM	SBM
SBN	SBN
SBOE	SBOE
SBOL	SBOL
SBOP	SBOP
Sborz	SBORZ
SBP	SBP
SBRJ	SBRJ
sb	SB
S. B.	SB
S.B.	SB
SB	SB
SBSE	SBSE
SBS	SBS
SBS's	SBS's
SBTDC	SBTDC
SBT	SBT
SBTU	SBTU
Sbu	SBU
SBU	SBU
SBY	SBY
SBZ	SBZ
S.C.A.	SCA
SCA	SCA
SCBA	SCBA
SCB	SCB
SCBWI	SCBWI
SCCA	SCCA
SCCA's	SCCA's
SCCC	SCCC
SCCI	SCCI
SCCP	SCCP
S.C.C.	SCC
SCC	SCC
scr	SCR
SCR	SCR
SCRs	SCR's
SCRS	SCRS
SCRTC	SCRTC
scry	SCRY
sc	SC
S. C.	SC
S.C.	SC
SC	SC
S.C.S.C.	SCSC
SC's	SC's
SCS	SCS
SCTC	SCTC
SCTE	SCTE
SCTO	SCTO
SCTP	SCTP
SCT	SCT
SCTS	SCTS
SCTV	SCTV
SCUAA	SCUAA
Scuf	SCUF
SCU's	SCU's
SCW	SCW
Scymn	SCYMN
SD&AE	SD and AE
SDAP	SDAP
SDAPS	SDAPS
SDA	SDA
SDAS	SDAS
SDASS	SDASS
SDAT	SDAT
SDAX	SDAX
SDB	SDB
SDCC	SDCC
SDCG	SDCG
SDC	SDC
SDDI	SDDI
SDDOT	SDDOT
SDD	SDD
SDDS	SDDS
Sdei	SDEI
sde	SDE
Sde	SDE
SDF	SDF
SDG&E	SDG and E
SDHA	SDHA
SDHC	SDHC
SDHD	SDHD
SDHHD	SDHHD
SDH	SDH
SDI	SDI
SDJ	SDJ
sdk	SDK
SDK	SDK
SDK's	SDK's
SDLC	SDLC
SDLP	SDLP
SDLP's	SDLP's
S. D. L.	SDL
S.D.N.Y.	SDNY
S. D.	SD
S.D.	SD
SDSM&T's	SDSM and T's
S. D. S.	SDS
S.E.C.	SEC
Sejms	SEJM's
sejr	SEJR
Sekl	SEKL
Sek	SEK
SEK	SEK
S. E.	SE
S.E.	SE
SESL	SESL
ses	SES
Ses	SE's
SEs	SE's
S.E.S.	SES
SES	SES
S.E.S.'s	SES's
S.E.X.	SEX
Seyh	SEYH
sfadb	SFADB
SFA	SFA
SFA's	SFA's
Sfax	SFAX
S.F.B.J.	SFBJ
SFB	SFB
SFCC	SFCC
SFCH	SFCH
SFC	SFC
SFDR	SFDR
SFD	SFD
SFE	SFE
SFES	SFES
SFFAS	SFFAS
SFFCo	SFFCO
SFFH	SFFH
SFF	SFF
SFG	SFG
SFI	SFI
S. F. L.	SFL
SFL	SFL
sfn	SFN
SFN	SFN
SFOR	SFOR
SFO	SFO
SFPA	SFPA
SFPD	SFPD
SFP	SFP
SFRA	SFRA
SFRJ	SFRJ
SFR	SFR
'sf	SF
sf	SF
S. F.	SF
S.F.	SF
SF	SF
SFSG	SFSG
SFSR	SFSR
sfs	SFS
S.F.'s	SF's
SFS	SFS
SFSS	SFSS
SFSU	SFSU
SFU	SFU
SFWA	SFWA
SFX	SFX
SFX's	SFX's
SGAE	SGAE
SGAP	SGAP
SGA	SGA
SG&A	SG and A
SGA's	SGA's
sgb	SGB
SGB	SGB
S.G.C.	SGC
SGC	SGC
SGD	SGD
SGE	SGE
S. G. F.	SGF
SGF	SGF
SGH	SGH
Sgip	SGIP
SGI	SGI
SGL	SGL
sgml	SGML
SGML	SGML
SGP	SGP
SGRAM	SGRAM
sgra	SGRA
SGR	SGR
S. G.	SG
S.G.	SG
SGSN	SGSN
SGSNs	SGSN's
SGS	SGS
SGSY	SGSY
Sgt.	sergeant
sgt	SGT
SGT	SGT
SGU	SGU
SGV	SGV
SGX	SGX
SHBG	SHBG
SHB	SHB
SHBT	SHBT
SHCA	SHCA
SHC	SHC
SHG	SHG
SHH	SHH
S.H.I.E.L.D.'s	SHIELD's
S.H.I.E.L.	SHIEL
SHL	SHL
Shma	SHMA
SHMD	SHMD
SHM	SHM
SHN	SHN
S. H.	SH
S.H.	SH
S.I.D.	SID
SIF	SIF
S.I.R.	SIR
S. I.	SI
S.I.	SI
S.I.T.	SIT
SJAM	SJAM
SJCH	SJCH
SJC	SJC
SJDA	SJDA
S.J.D.	SJD
sjef	SJEF
SJEM	SJEM
S. J. J. F.	SJJF
SJK	SJK
S.J.L.	SJL
SJL	SJL
SJM	SJM
Sjon	SJON
SJPCD	SJPCD
SJP	SJP
SJPT	SJPT
SJR	SJR
SJR's	SJR's
S. J.	SJ
S.J.	SJ
SJ	SJ
SKB	SKB
SKC	SKC
SKD	SKD
S. K. F.	SKF
SKF	SKF
SKG	SKG
SKH	SKH
SKJ	SKJ
SKPC	SKPC
SKP	SKP
SKR	SKR
SKSD	SKSD
S. K.	SK
S.K.	SK
SK	SK
S. K. S.	SKS
S.L.A.A.'s	SLAA's
SLAF	SLAF
sla	SLA
SLA	SLA
SLAs	SLA's
SLCO	SLCO
SLC	SLC
SLDL	SLDL
SLD	SLD
S.L.E.	SLE
SLF	SLF
SLG	SLG
SLHS	SLHS
S.L.I.F.E.R.	SLIFER
SLL	SLL
SLMC	SLMC
S. L. M.	SLM
SLM	SLM
SLN	SLN
SLPIM	SLPIM
SLP	SLP
SLRC	SLRC
SLR	SLR
S&L	S and L
SLS&E	SLS and E
SLSF	SLSF
SLSK	SLSK
S. L.	SL
S.L.	SL
SL	SL
SLS	SLS
SLVR	SLVR
SLV	SLV
S.M.A.R.T.	SMART
S.M.A.S.H.	SMASH
SMA	SMA
SMB	SMB
SMe	SME
SME	SME
SME's	SME's
SMEs	SME's
SMF	SMF
SMG	SMG
SMHI	SMHI
SMH	SMH
SmI	SMI
SMI	SMI
SMJR	SMJR
SMK	SMK
SMLS	SMLS
SMMT	SMMT
SMN	SMN
SMNS	SMNS
SMP	SMP
SMP's	SMP's
SMPSs	SMPS's
SMPTE	SMPTE
SMRJ	SMRJ
smr	SMR
SMR	SMR
S&M	S and M
sm	SM
S. M.	SM
S.M.	SM
SM	SM
S.M.'s	SM's
SMs	SMS
S.M.S.	SMS
SMS	SMS
SMS's	SMS's
SMSU	SMSU
SMTP	SMTP
S.M.T.	SMT
SMT	SMT
SMTV	SMTV
SMU	SMU
SMW	SMW
SMX	SMX
Smyl	SMYL
SMYS	SMYS
SNA	SNA
SNBA	SNBA
SNB	SNB
SNCB	SNCB
SNCC	SNCC
SNCF	SNCF
SNC	SNC
SNDC	SNDC
SND	SND
SNEP	SNEP
SNESjr	SNESJR
SNES	SNES
SNET	SNET
SNF	SNF
SNFU	SNFU
sngle	SNGLE
SNG	SNG
SNK	SNK
SNLA	SNLA
SNL	SNL
SNLS	SNLS
SNMCMG	SNMCMG
SNMC	SNMC
SNMMA	SNMMA
SNMP	SNMP
SNNPR	SNNPR
SNNR	SNNR
SNPJ	SNPJ
SNP	SNP
SNPs	SNP's
SNRI	SNRI
SNR	SNR
SNSD's	SNSD's
SnSe	SNSE
S. N.	SN
S.N.	SN
SN	SN
SNS	SNS
S.O.E.	SOE
S. O.	SO
S.O.	SO
Sos	SO's
S.O.S.	SOS
SOS	SOS
Sovn	SOVN
Sov	SOV
SOX	SOX
S. O. Y.	SOY
S&P 500	S and P five  hundred
S.P.A.L.	SPAL
SPB	SPB
SPCAs	SPCA's
SPCG	SPCG
SPCK	SPCK
S.P.C.	SPC
SPC	SPC
SPDI	SPDI
SPD	SPD
Spe	SPE
SPE	SPE
SPES	SPES
SPFH	SPFH
SPFL	SPFL
SPF	SPF
SPG	SPG
SPHL	SPHL
SPH	SPH
SPINE's	SPINE's
SPIN's	SPIN's
SPIR	SPIR
SPI	SPI
S.P.I.T.	SPIT
SPJA	SPJA
SPK	SPK
SPLA	SPLA
SPLC	SPLC
SPL	SPL
SPME	SPME
SPML	SPML
SPMRL	SPMRL
SPM	SPM
SPNJ	SPNJ
SPNM	SPNM
SPNN	SPNN
SPN	SPN
Spoa	SPOA
SPOC	SPOC
SPOF	SPOF
SPO	SPO
SPOU	SPOU
SpPIn	SPPIN
SPP	SPP
SPP's	SPP's
SPQA	SPQA
SPRL	SPRL
SPRM	SPRM
SPR	SPR
SPRU	SPRU
S&P	S and P
SPSA	SPSA
SPSL	SPSL
S. P.	SP
S.P.	SP
SP	SP
SP's	SP's
SPs	SP's
SPS	SPS
SPSS	SPSS
SPTA	SPTA
SPT	SPT
SPUC	SPUC
SPUP	SPUP
SPU	SPU
SPUs	SPU's
SPV	SPV
SQA	SQA
SQBB	SQBB
SQI	SQI
sql	SQL
SQL	SQL
SQM	SQM
sq	SQ
S. Q.	SQ
SQ	SQ
Sra	SRA
SRA	SRA
SRAs	SRA's
Srba	SRBA
SRBIJA	SRBIJA
Srbi	SRBI
SRBOC	SRBOC
SRBP	SRBP
SRB	SRB
SRBs	SRB's
SRBY	SRBY
SRCC	SRCC
SRCL	SRCL
SRC	SRC
SRC's	SRC's
SRCS	SRCS
S.R.E.	SRE
SRE	SRE
SRFC	SRFC
S.R.F.	SRF
SRF	SRF
S.R.G.	SRG
SRG	SRG
SRGs	SRG's
Srhir	SRHIR
SRH	SRH
S. R. J.	SRJ
SRK	SRK
SRK's	SRK's
SRLGs	SRLG's
S.R.L.	SRL
SRL	SRL
SRMC	SRMC
S.R.M.	SRM
SRM	SRM
SRMs	SRM's
Srni	SRNI
SRN	SRN
srp	SRP
SRPT	SRPT
S. R. R.	SRR
SRR	SRR
sr	SR
S. R.	SR
S.R.	SR
SR	SR
SRS	SRS
SRT	SRT
SRT's	SRT's
Srul	SRUL
SRU	SRU
SRU's	SRU's
SRV	SRV
srx	SRX
SRY	SRY
SSAA	SSAA
SSAB	SSAB
SSAC	SSAC
SSAR	SSAR
SSA	SSA
SSAs	SSA's
SSBSE	SSBSE
S.S.B.	SSB
SSB	SSB
SSCCC	SSCCC
S.S.C.	SSC
SSC	SSC
SSCV	SSCV
SSDB	SSDB
SSDL	SSDL
SSDP	SSDP
S.S.D.	SSD
SSD	SSD
SSDs	SSD's
SSE	SSE
SSFL	SSFL
SSF	SSF
SSGRC	SSGRC
SSG	SSG
SSHSA's	SSHSA's
SSH	SSH
SSI	SSI
SSIS	SSIS
SSJA	SSJA
SSKI's	SSKI's
SSK	SSK
SSLAM	SSLAM
ssl	SSL
SSL	SSL
SSLT	SSLT
SSME	SSME
SSM	SSM
SSN	SSN
SSOD	SSOD
SSOF	SSOF
SSO	SSO
SSoSV	SSOSV
SSPA	SSPA
SSPH	SSPH
SSPR	SSPR
SSP	SSP
SSPX	SSPX
SSQ	SSQ
SSRAA	SSRAA
SSRF	SSRF
SSRI	SSRI
SSRIs	SSRI's
SSRN	SSRN
SSRP	SSRP
SSR	SSR
S&S	S and S
SSSC	SSSC
SSSI	SSSI
SSSR	SSSR
ss	SS
S. s	S's
Ss	S's
S. S.	SS
S.S.	SS
SSS	SSS
SSTH	SSTH
SSTL	SSTL
SSTR	SSTR
SST	SST
Ssu	SSU
SSU	SSU
SSVC	SSVC
SSV	SSV
SSWAHS	SSWAHS
SSWC	SSWC
ssw	SSW
SSW	SSW
SSX	SSX
Ssy	SSY
ST&AJ	ST and AJ
S.T.A.L.K.E.R.	STALKER
S.T.A.T.U.S.	STATUS
STB	STB
STCC	STCC
S.T.C.	STC
STC	STC
STCW	STCW
STDP	STDP
STDs	STD's
STD	STD
STF	STF
stfv	STFV
STGs	STG's
STG	STG
STIs	STI's
STIS	STIS
STi	STI
STI	STI
STK	STK
stl	STL
S.T.L.	STL
STL	STL
STMB	STMB
STMIK	STMIK
STM's	STM's
STM	STM
STNS	STNS
STN	STN
STPI	STPI
STPNS	STPNS
STPRI	STPRI
STP	STP
S.T.R.I.D.E.	STRIDE
STRV	STRV
Stryj	STRYJ
STRZ	STRZ
S&T	S and T
STScI	STSCI
ST's	ST's
STS	STS
S. T.	ST
S.T.	ST
STT	STT
STVL	STVL
STVS	STVS
STV	STV
STXBP	STXBP
STX	STX
S.U.C.	SUC
SUDV	SUDV
suo	SUO
Suo	SUO
S. U.	SU
SUSV	SUSV
Susz	SUSZ
SUTs	SUT's
SUT	SUT
Suu	SUU
SUVF	SUVF
SUVs	SUV's
SUV	SUV
SUWN	SUWN
SUW	SUW
Suy	SUY
Svac	SVAC
svar	SVAR
SVA	SVA
SVB	SVB
SVC	SVC
SVD	SVD
sve	SVE
Sve	SVE
SVGA	SVGA
SVG	SVG
SVGT	SVGT
SVIA	SVIA
SVM's	SVM's
SVMs	SVM's
SVM	SVM
svn	SVN
svom	SVOM
SVOPC	SVOPC
SVO	SVO
SVP	SVP
SVPW	SVPW
SVSCEP	SVSCEP
SVSC	SVSC
SVS	SVS
sv	SV
S. V.	SV
S.V.	SV
SV	SV
SVTs	SVT's
SVT	SVT
S.V.U.	SVU
SVU	SVU
SVV	SVV
SVW	SVW
SVYASA	SVYASA
SVZ	SVZ
SWABC	SWABC
SWAC	SWAC
S.W.A.	SWA
SWC	SWC
SWD	SWD
S.W.E.A.T.	SWEAT
Swe	SWE
SWE	SWE
SWF	SWF
SWG	SWG
SWHL	SWHL
SWHS	SWHS
SWH	SWH
SWJN	SWJN
S. W. K.	SWK
SWMRS	SWMRS
SWM	SWM
SWNH	SWNH
SWOC	SWOC
S.W.O.R.D.	SWORD
SWPA	SWPA
SWPL	SWPL
SWP	SWP
SwRI	SWRI
SWR	SWR
S&W	S and W
SWS	SWS
sw	SW
S. W.	SW
S.W.	SW
SW	SW
SWTPC	SWTPC
SWT	SWT
SWWTP	SWWTP
SXCT	SXCT
SXN	SXN
SXSW	SXSW
sx	SX
S.X.	SX
SX	SX
SXY	SXY
SXZ	SXZ
SysML	SYSML
SysRq	SYSRQ
Sys	SY's
SYS	SYS
SysV	SYSV
S. Y.	SY
S.Y.	SY
SyT	SYT
syv	SYV
Syxx	SYXX
SZA	SZA
Szasz	SZASZ
SZDSZ	SZDSZ
Szer	SZER
szkic	SZKIC
Szklo	SZKLO
Szlak	SZLAK
SzMME	SZMME
Szpir	SZPIR
SZSE	SZSE
sz	SZ
S. Z.	SZ
SZ	SZ
Szu	SZU
Szyk	SZYK
SZZ	SZZ
taf	TAF
Taf	TAF
TAF	TAF
T.A.P.	TAP
T.A.S.	TAS
T. A.	TA
T.A.	TA
T&A	T and A
TAZ	TAZ
TBA	TBA
TBCA	TBCA
TBCs	TBC's
TBCS	TBCS
TBD	TBD
TBE	TBE
TBF	TBF
TBHS	TBHS
TBI	TBI
TBK	TBK
TBL	TBL
TBMA	TBMA
TBMM	TBMM
TBMs	TBM's
T.B.M.	TBM
TBM	TBM
TBNJ	TBNJ
TBN	TBN
TBP	TBP
TBSC	TBSC
TBS	TBS
T. B.	TB
T.B.	TB
TB	TB
TBTG	TBTG
TBT	TBT
TBV	TBV
TBWA	TBWA
TBX	TBX
TCAR	TCAR
TCA	TCA
TCC	TCC
TCDB	TCDB
TCDC	TCDC
TCDD	TCDD
TCDOG	TCDOG
TCDSB	TCDSB
TCEB	TCEB
T.C.E.	TCE
TCE	TCE
TCFAQ	TCFAQ
TCF	TCF
TCGA	TCGA
TCG	TCG
TCHC	TCHC
TCHRD	TCHRD
TCH	TCH
TCiAP	TCIAP
TCI	TCI
TCKs	TCK's
TCLP	TCLP
TCL	TCL
TCM	TCM
TCO	TCO
TCPL	TCPL
TCPMP	TCPMP
TCP's	TCP's
TCP	TCP
TCR	TCR
T. C. S.	TCS
TCS	TCS
tc	TC
T. C.	TC
T.C.	TC
TC	TC
TCT	TCT
TCU's	TCU's
TCUs	TCU's
tcu	TCU
TCU	TCU
TCV	TCV
TCWC	TCWC
TCWP	TCWP
TCW	TCW
TDA	TDA
tdb	TDB
TDCC	TDCC
TDCi	TDCI
TDCJ	TDCJ
TDC's	TDC's
TDC	TDC
TDD	TDD
TDE	TDE
TDF	TDF
TDH	TDH
TdIF	TDIF
TDI	TDI
TDK	TDK
TDLAS	TDLAS
TDMA	TDMA
TDME	TDME
TDM	TDM
TDO	TDO
TDP	TDP
TDRS	TDRS
TDR	TDR
TDSB's	TDSB's
TD's	TD's
TDs	TD's
T. D.	TD
T.D.	TD
TDT	TDT
Teatr	TEATR
TEBD	TEBD
T. E.	TE
T.E.	TE
TEVT	TEVT
TFAP	TFAP
TFAS	TFAS
TFA	TFA
TFC	TFC
TFCU	TFCU
TFF	TFF
TFG	TFG
T.F.H.	TFH
TFH	TFH
TFIH	TFIH
TFIID	TFIID
TFK	TFK
TFL	TFL
TFM	TFM
TFN	TFN
TFO	TFO
TFP	TFP
TFR	TFR
TFSA	TFSA
TFSI	TFSI
TFSP	TFSP
TFS	TFS
T&F	T and F
TFTC	TFTC
tf	TF
T. F.	TF
T.F.	TF
TF	TF
TFTR	TFTR
TFT	TFT
TFVC	TFVC
TFWA	TFWA
TFW	TFW
TGA	TGA
T. G. C.	TGC
TGC	TGC
tge	TGE
T.G.E.	TGE
TGE	TGE
tgf	TGF
TGF	TGF
TGG	TGG
TGIF	TGIF
TGL	TGL
TGM's	TGM's
TGM	TGM
TGP	TGP
TGS	TGS
tg	TG
T. G.	TG
T.G.	TG
TG	TG
TGVs	TGV's
tgv	TGV
TGV	TGV
THB	THB
THCF	THCF
THC	THC
T.H.E.M.	THEM
T.H.F.	THF
THF	THF
THG	THG
THHK	THHK
T.H.I.N.K. B.I.G.	THINKBIG
THLL	THLL
THL	THL
THMP	THMP
THM	THM
THNN	THNN
Thok	THOK
T.H.P.	THP
THQ's	THQ's
THQ	THQ
THR's	THR's
THR	THR
ThSe	THSE
THSR	THSR
T. H. S.	THS
T. H.	TH
T.H.	TH
T.H.U.N.D.E.R.	THUNDER
THW	THW
THX	THX
TIAA	TIAA
T. I. A.	TIA
TIFR	TIFR
TIF	TIF
T.I.'s	TI's
T.I.	TI
Tiu	TIU
tiv	TIV
Tiv	TIV
TIYM	TIYM
Tiy's	TIY's
TJFR	TJFR
T.J.F.	TJF
T. J. J.	TJJ
TJJ	TJJ
TJP	TJP
TJRC	TJRC
T. J. S.	TJS
T. J.	TJ
T.J.	TJ
TJ	TJ
t'ju	TJU
TJX	TJX
tjz	TJZ
TKAG	TKAG
TKA's	TKA's
TKA	TKA
T. K. B.	TKB
TKD	TKD
TKE	TKE
TKI	TKI
tko	TKO
Tko	TKO
TKO	TKO
TKP	TKP
TK's	TK's
TKS	TKS
tk	TK
T. K.	TK
T.K.	TK
TK	TK
TKT	TKT
Tlas	TLA's
TLA	TLA
TLC's	TLC's
TLC	TLC
TlCu	TLCU
TLDs	TLD's
TLDS	TLDS
TLD	TLD
TLE	TLE
TLF	TLF
TLG	TLG
TLH	TLH
tli	TLI
TLI	TLI
TLM	TLM
TLN	TLN
tlp	TLP
TLP	TLP
TLRs	TLR's
TLR	TLR
TLs	TL's
TLS	TLS
TLTB	TLTB
tl	TL
T. L.	TL
T.L.	TL
TL	TL
Tluk	TLUK
TLU's	TLU's
Tluszcz	TLUSZCZ
TLV	TLV
TMA	TMA
TMBG	TMBG
TMB	TMB
tmc	TMC
TMC	TMC
TMDL	TMDL
TMD	TMD
TMEM	TMEM
TMF	TMF
TMGs	TMG's
TMG	TMG
TMI	TMI
TMJ	TMJ
T. M. M.	TMM
TMMTX	TMMTX
TMNT	TMNT
TMOK	TMOK
tmos	TMOS
TMO's	TMO's
TMOS	TMOS
TMO	TMO
TMPRSS	TMPRSS
TMP	TMP
tmRNA	TMRNA
TMRS	TMRS
TMR	TMR
TMSI	TMSI
TMSs	TMS's
T.M.s	TM's
TM's	TM's
TMS	TMS
tm	TM
T. M.	TM
T.M.	TM
TM	TM
T.M.T.	TMT
TMT	TMT
TMU	TMU
TMX	TMX
TMZ	TMZ
TNA's	TNA's
TNAS	TNAS
tna	TNA
TNA	TNA
tnbc	TNBC
TNCA	TNCA
TNCC	TNCC
TNCDSB	TNCDSB
TNC	TNC
TNFA	TNFA
TNFRSF	TNFRSF
TNFSF	TNFSF
TNF	TNF
TNGHT	TNGHT
TNG	TNG
TNIP	TNIP
TNI	TNI
TNL	TNL
TNMM	TNMM
TNMS	TNMS
TNM	TNM
TNNC	TNNC
TNN	TNN
TNO	TNO
TNPL	TNPL
TNP	TNP
TNQ	TNQ
TNRIS	TNRIS
TNRP	TNRP
TNR	TNR
TNSDL	TNSDL
TNSTC	TNSTC
TNS	TNS
TNTAs	TNTA's
tn	TN
T. N.	TN
T.N.	TN
TN	TN
TNT's	TNT's
TNT	TNT
T.O.'s	TO's
T. O.	TO
T.O.	TO
TOTP	TOTP
tou	TOU
Tou	TOU
ToU	TOU
TOU	TOU
TPAC	TPAC
TPAO	TPAO
tPA	TPA
TPA	TPA
TPB	TPB
TPC	TPC
TPEC	TPEC
TPF	TPF
TPG	TPG
TPH	TPH
TPI	TPI
TPLF	TPLF
TPMS	TPMS
TPM	TPM
TPO	TPO
TPP	TPP
tpr	TPR
TPR	TPR
TPS	TPS
tp	TP
T. P.	TP
T.P.	TP
TP	TP
TPU	TPU
TPVs	TPV's
TPWS	TPWS
TPW	TPW
TQR	TQR
TQS	TQS
T.Q.	TQ
TQ	TQ
tra	TRA
Tra	TRA
TRA	TRA
TRAXX	TRAXX
Trbic	TRBIC
T. R. B.	TRB
TRB	TRB
Trcek	TRCEK
TRC	TRC
TRD	TRD
TRFA	TRFA
TRF	TRF
TRG	TRG
TRHS	TRHS
TRH	TRH
T.R.I.B.E.	TRIBE
TRIZ	TRIZ
TrkA	TRKA
TRL	TRL
Trmcic	TRMCIC
TRMM	TRMM
T.R.M.P.A.	TRMPA
T. R. M.	TRM
tRNA	TRNA
TRNC	TRNC
TRPC	TRPC
TRPM	TRPM
TRPP	TRPP
TRP's	TRP's
TRPs	TRP's
TRP	TRP
TRPV	TRPV
TRPY	TRPY
TRSC	TRSC
TRSI	TRSI
trs	TRS
T.R.S.	TRS
TRS	TRS
TRSV	TRSV
tr	TR
T. R.	TR
T.R.	TR
TR	TR
TRT	TRT
T.R.U.	TRU
truTV	TRUTV
TruTV	TRUTV
Trve	TRVE
TRVL	TRVL
TRV	TRV
TRW	TRW
TRX	TRX
TRZ	TRZ
Tsa	TSA
TSA	TSA
TSB	TSB
TSCC	TSCC
TSC	TSC
TSF	TSF
TSG	TSG
TSH	TSH
TSI	TSI
tsit	TSIT
Tsiv	TSIV
TSJDF	TSJDF
TSLA	TSLA
TSLC	TSLC
TSL	TSL
TSN	TSN
T.S.O.L.	TSOL
tso	TSO
Tso	TSO
T.S.O.	TSO
TSO	TSO
TSP	TSP
TSRA	TSRA
TSRTC	TSRTC
tsr	TSR
TSR	TSR
TSSA	TSSA
TSS	TSS
TSTA	TSTA
TSTC	TSTC
Ts	T's
T. S.	TS
T.S.	TS
TS	TS
TST	TST
tsus	TSUS
Tsvi	TSVI
TSV	TSV
TSW	TSW
TSX	TSX
TTAB	TTAB
Tta	TTA
TTA	TTA
TTBB	TTBB
TTCP	TTCP
TTC's	TTC's
TTC	TTC
TTDC	TTDC
TTD	TTD
tteok	TTEOK
tte	TTE
TTFF	TTFF
TTHS	TTHS
TTH	TTH
TTI	TTI
TTKG	TTKG
TTKST	TTKST
TTL	TTL
T.T.N.	TTN
ttp	TTP
TTP	TTP
TTR	TTR
TTS	TTS
T&T	T and T
T. T.	TT
T.T.	TT
TT	TT
TTU	TTU
TTV	TTV
TTW	TTW
TUAW	TUAW
TUBB	TUBB
TUDCA	TUDCA
TUHUS	TUHUS
TUKP's	TUKP's
T'uqu	TUQU
TUSCC	TUSCC
TUSC	TUSC
T.U.	TU
TU	TU
Tuzk	TUZK
tvaan	TVAAN
Tvam	TVAM
TVARK	TVARK
tva	TVA
TVA	TVA
TVB's	TVB's
TVB	TVB
TVCM	TVCM
TVC	TVC
TVD	TVD
TVETs	TVET's
TVE	TVE
TVF	TVF
TVGN	TVGN
TVGOS	TVGOS
TVii	TVII
TVIn	TVIN
TVi	TVI
TVI	TVI
TVL	TVL
TVMK	TVMK
TVM	TVM
TVN	TVN
TVNZ's	TVNZ's
TVNZ	TVNZ
tvo	TVO
Tvo	TVO
TVO	TVO
TVP	TVP
TVRi	TVRI
tvr	TVR
TVR	TVR
TVSpy	TVSPY
tvs	TVS
TV's	TV's
TVs	TV's
TVS	TVS
tVTA	TVTA
TVT	TVT
tv	TV
T. V.	TV
T.V.	TV
TV	TV
TVXQ's	TVXQ's
TVXQ	TVXQ
TVX	TVX
TWAP	TWAP
TWA's	TWA's
Twa	TWA
TWA	TWA
T. W. B.	TWB
TWCS	TWCS
TWC	TWC
TWF	TWF
Twi	TWI
TWI	TWI
TWK	TWK
T.W.P.	TWP
TWP	TWP
TWR	TWR
TWTs	TWT's
TWT	TWT
T. W.	TW
T.W.	TW
TW	TW
T.W.U.	TWU
TWU	TWU
TXC	TXC
TxDOT	TXDOT
TXII	TXII
TXJS	TXJS
TXK	TXK
TXMM	TXMM
TXNDC	TXNDC
TXP	TXP
TXTC	TXTC
TXT	TXT
T.X.	TX
TX	TX
TXU	TXU
tya	TYA
TYC	TYC
TYIB	TYIB
TYIN	TYIN
Tyk	TYK
Tza'ar	TZAAR
Tze	TZE
TZL	TZL
Tzrif	TZRIF
Tzuh	TZUH
TZUM	TZUM
Tzvi	TZVI
UAAP's	UAAP's
UAAP	UAAP
UAB's	UAB's
UAB	UAB
UAC	UAC
UADY	UADY
UAE's	UAE's
U.A.E.	UAE
UAE	UAE
UAF	UAF
UAHC	UAHC
UAIC	UAIC
UAI	UAI
UALR	UALR
UAL	UAL
UALVP	UALVP
UAM	UAM
UANL	UANL
UAN	UAN
UAOC	UAOC
UAP	UAP
UAR's	UAR's
UARS	UARS
UAR	UAR
UASLP	UASLP
UASL	UASL
Ua's	UA's
UAs	UA's
UAS	UAS
uat	UAT
U.A.	UA
UA	UA
UAVs	UAV's
UAV	UAV
U.A.W.	UAW
UAW	UAW
Uba	UBA
UBA	UBA
UBBC	UBBC
UBB	UBB
UbcM	UBCM
UBC's	UBC's
UBC	UBC
UBD	UBD
Ube	UBE
UBE	UBE
ubi	UBI
Ubi	UBI
U.B.I.	UBI
UBI	UBI
UBM's	UBM's
UBM	UBM
UBOS	UBOS
UBO	UBO
UBPR	UBPR
UBP	UBP
UBRE	UBRE
UBRS	UBRS
UB's	UB's
UBS	UBS
UB	UB
UBU	UBU
UBV	UBV
UBX	UBX
UCAC	UCAC
Ucar	UCAR
UCAR	UCAR
Uca	UCA
UCA	UCA
UCAV	UCAV
UCBH	UCBH
UCBTLA	UCBTLA
UCB	UCB
UCCE	UCCE
UCCJ	UCCJ
UCCS	UCCS
UCC	UCC
UCDA	UCDA
UCDP	UCDP
UCD	UCD
UCF's	UCF's
UCF	UCF
UCG	UCG
UCIEP	UCIEP
UCI's	UCI's
UCI	UCI
UCLA's	UCLA's
UCLA	UCLA
UCLH	UCLH
UCL	UCL
Ucmak	UCMAK
UCMJ	UCMJ
UCMMA	UCMMA
UCMP	UCMP
UCM	UCM
Ucn	UCN
UCOS	UCOS
UCO	UCO
UCP	UCP
UCREF	UCREF
UCR	UCR
UCSB	UCSB
UCSC	UCSC
UCSD's	UCSD's
UCSD	UCSD
UCSF	UCSF
UCSN	UCSN
uCs	UC's
UCS	UCS
UCTI	UCTI
UCT	UCT
Uc	UC
U.C.	UC
UC	UC
Ucuncu	UCUNCU
UCU	UCU
UCVTS	UCVTS
UCW	UCW
Uczta	UCZTA
UDAR	UDAR
UDA's	UDA's
Uda	UDA
UDA	UDA
UDC	UDC
UDF	UDF
UDG	UDG
UDHR	UDHR
UDICHI	UDICHI
Udit	UDIT
UDK	UDK
UDN	UDN
Udny	UDNY
UDP	UDP
UDRP	UDRP
UDR	UDR
UDS	UDS
UDTs	UDT's
UDT	UDT
ud	UD
Ud	UD
U. D.	UD
UD	UD
udu	UDU
Udu	UDU
UDYCO	UDYCO
UEA	UEA
UEBT	UEBT
UEC	UEC
Ueda's	UEDA's
Uéda	UE acute DA
UEFA's	UEFA's
UEFA	UEFA
UEFI	UEFI
UEFS	UEFS
UEF	UEF
UEGCL	UEGCL
UEI	UEI
UET	UET
U. E.	UE
UE	UE
UFABC	UFABC
UFA's	UFA's
UFCO	UFCO
UFC's	UFC's
UFC	UFC
UFCW	UFCW
UFD	UFD
UFE	UFE
UFF	UFF
UFIA	UFIA
UFIP	UFIP
UFI	UFI
UFJ	UFJ
UFL's	UFL's
UFL	UFL
UFM	UFM
UFOFU	UFOFU
UFORE	UFORE
UFO's	UFO's
UFOs	UFO's
Ufot	UFOT
ufo	UFO
Ufo	UFO
UFO	UFO
UFPE	UFPE
UFPLS	UFPLS
UFPR	UFPR
UFRGS	UFRGS
UFRJ	UFRJ
UFSB	UFSB
UFSM	UFSM
UF's	UF's
UFS	UFS
UFTP	UFTP
UFT	UFT
U. F.	UF
UF	UF
UFU	UFU
UFW	UFW
Uga	UGA
UGA	UGA
UGCCWA	UGCCWA
UGC	UGC
Uge	UGE
UGK	UGK
UGME	UGME
Ugni	UGNI
UGP	UGP
Ugra	UGRA
Ugrszke	UGRSZKE
UGS	UGS
UGT	UGT
Ug	UG
UG	UG
UHD	UHD
UHF	UHF
Uhha	UHHA
UHMW	UHMW
uhn	UHN
UHOA	UHOA
UHPT	UHPT
UHP	UHP
UHRA	UHRA
UHRF	UHRF
UHSAA	UHSAA
UHTCs	UHTC's
UHTI	UHTI
Uhud	UHUD
U.H.	UH
uhur	UHUR
UIAA	UIAA
Uiam	UIAM
UIA	UIA
UIAW	UIAW
Uibh	UIBH
Uible	UIBLE
UIC	UIC
UID	UID
UIFL	UIFL
Uig	UIG
UIL	UIL
UIMC	UIMC
UIM	UIM
UIN	UIN
UIP	UIP
uisae	UISAE
UISD	UISD
UiS	UIS
UI's	UI's
UIS	UIS
UiTM	UITM
uit	UIT
Uit	UIT
UIT	UIT
UI	UI
UIV	UIV
Uiy	UIY
UJA	UJA
UJC	UJC
Ujed	UJED
UJEP	UJEP
Ujsag	UJSAG
UJS	UJS
uj	UJ
U.J.	UJ
UJ	UJ
Uka	UKA
UKA	UKA
UKCC	UKCC
UKC	UKC
Ukhra	UKHRA
Ukic	UKIC
UKIP's	UKIP's
Uki	UKI
UKM	UKM
UKNC	UKNC
Ukoh	UKOH
Uko	UKO
UKPC	UKPC
UKRDA's	UKRDA's
UKRDA	UKRDA
ukr	UKR
Ukr	UKR
UKR	UKR
UK's	UK's
UKTV's	UKTV's
UKTV	UKTV
Ukui	UKUI
u'k	UK
uk	UK
Uk	UK
U.K.	UK
UK	UK
UKUP	UKUP
UKVRN	UKVRN
UKW	UKW
Ukwu	UKWU
ULC	ULC
ULDB	ULDB
ULEB	ULEB
ULEV	ULEV
ULFA	ULFA
Ulic	ULIC
Ull	ULL
Ulms	ULM's
UL's	UL's
ULS	ULS
UlSU	ULSU
Uluj	ULUJ
U.L.	UL
UL	UL
ulus	ULUS
Ulus	ULU's
ULV	ULV
Ulwa	ULWA
Ulwe	ULWE
UMBC	UMBC
Umbr	UMBR
UMCC	UMCC
UMC	UMC
UMD	UMD
umelcu	UMELCU
UMe	UME
UMF	UMF
UMG	UMG
UMHB	UMHB
UMH	UMH
UMKC's	UMKC's
UMKC	UMKC
UMK	UMK
Umla	UMLA
UML	UML
Umme	UMME
UMMSM	UMMSM
UMNO's	UMNO's
Umno	UMNO
UMNO	UMNO
UMN	UMN
UMO	UMO
UMPP	UMPP
UMP's	UMP's
Umri	UMRI
UM's	UM's
UMTS	UMTS
UMTV	UMTV
UMUC	UMUC
U. M.	UM
U.M.	UM
UMWA's	UMWA's
UMWA	UMWA
UMW's	UMW's
UNAB	UNAB
UNAFF	UNAFF
UNAH	UNAH
UNAMIR	UNAMIR
UNAPACK's	UNAPACK's
UNB	UNB
UNCAC	UNCAC
UNCAF	UNCAF
UNCG's	UNCG's
UNCG	UNCG
UNCHE	UNCHE
UNCHS	UNCHS
UNCMAC	UNCMAC
UNCRO	UNCRO
UNC's	UNC's
UNCTAD	UNCTAD
UNC	UNC
UNCW	UNCW
UNFCCC	UNFCCC
UNFICYP	UNFICYP
UNFPA	UNFPA
UNFP	UNFP
UNF	UNF
UNFWP	UNFWP
UNGC	UNGC
UNHCR	UNHCR
UNHRC's	UNHRC's
UNH	UNH
UNJLC	UNJLC
Unli	UNLI
UNL	UNL
Unlu	UNLU
UNLV	UNLV
UNMCK	UNMCK
UNMC	UNMC
UNMEE's	UNMEE's
UNMEE	UNMEE
UNMIH	UNMIH
UNMIK	UNMIK
UNMIL	UNMIL
UNMOVIC	UNMOVIC
unm	UNM
UNM	UNM
UNNC	UNNC
unnd	UNND
UNODC	UNODC
UNOMIG	UNOMIG
UNPA	UNPA
UNPD	UNPD
UNPO	UNPO
UNP	UNP
UNRA	UNRA
UNRSGN	UNRSGN
UNRWA	UNRWA
UNSCOM	UNSCOM
UNSCR	UNSCR
UNSC's	UNSC's
UNSC	UNSC
UNSh	UNSH
Unst	UNST
Uns	UN's
U.N.'s	UN's
UNSW	UNSW
UNTSO	UNTSO
UNTS	UNTS
Unt	UNT
UNT	UNT
U.N.	UN
UNU	UNU
UNV	UNV
UNWE	UNWE
UNWTO	UNWTO
Unz	UNZ
UOCl	UOCL
UODA	UODA
UofM	UOFM
UOHI	UOHI
Uoho	UOHO
UOJCA	UOJCA
UOL	UOL
UOMINI	UOMINI
UoMs	UOM's
UOP	UOP
uORF	UORF
UOR	UOR
UO's	UO's
UO	UO
UoW	UOW
UPABA	UPABA
UPBs	UPB's
UPCI	UPCI
UPC	UPC
UPDRS	UPDRS
UPDS	UPDS
Upd	UPD
UPD	UPD
UPEC	UPEC
UPFA	UPFA
UPF's	UPF's
Upf	UPF
UPF	UPF
UPGMA	UPGMA
UPHSD	UPHSD
UPIN	UPIN
Upir	UPIR
UPI's	UPI's
UPI	UPI
UPLA	UPLA
UPLB	UPLB
UPL	UPL
UPMC	UPMC
UPMSS	UPMSS
UPND	UPND
UPNE	UPNE
UPnP	UPNP
UPN	UPN
UPOV	UPOV
UPPP	UPPP
Uppu	UPPU
UPRR	UPRR
UPR	UPR
UPSC	UPSC
U.P.S.E.B.	UPSEB
UPSIDC	UPSIDC
UPSID	UPSID
UPSI	UPSI
UPSMF	UPSMF
UPTI	UPTI
UPTU	UPTU
U.P.	UP
UPW	UPW
UPX	UPX
UPyD	UPYD
UQAIB	UQAIB
UQAM's	UQAM's
UQC	UQC
U.Q.P.	UQP
UQP	UQP
uq	UQ
UQ	UQ
URAA	URAA
URAC	URAC
URAP	URAP
URBACT	URBACT
URBED	URBED
Urbz	URBZ
URCL	URCL
URCSA	URCSA
URCs	URC's
URC	URC
Urdd	URDD
Urei	UREI
urf	URF
Urla	URLA
URLhttp	URLHTTP
URLs	URL's
URL	URL
URNU	URNU
UROC	UROC
URRACA	URRACA
URSB	URSB
URSEC	URSEC
URSS	URSS
URW's	URW's
URW	URW
URZ	URZ
USAACE	USAACE
USAAC	USAAC
U.S.A.A.F.	USAAF
USAAF	USAAF
USAB	USAB
USACE	USACE
USAC	USAC
USAFE	USAFE
USAF	USAF
USAHA	USAHA
USAID's	USAID's
USAID	USAID
Usal	USAL
usan	USAN
Usan	USAN
USAN	USAN
usao	USAO
USAO	USAO
USAPA	USAPA
USARPS	USARPS
USASA	USASA
USA's	USA's
usata	USATA
USATF	USATF
USAT	USAT
usa	USA
.USA	USA
U.S.A.	USA
U.S.A	USA
USA	USA
USAya	USAYA
USBA	USBA
USBC's	USBC's
USBC	USBC
USBs	USB's
USB	USB
USBWA	USBWA
USCCB	USCCB
USCF	USCF
USCGAUX	USCGAUX
USCGC	USCGC
USCG	USCG
USCHS	USCHS
Uscie	USCIE
USCIRF	USCIRF
USCIS	USCIS
USCITA	USCITA
USCOB	USCOB
USCRP	USCRP
U.S.C.'s	USC's
USC's	USC's
USCT	USCT
U.S.C.	USC
USC	USC
USDA's	USDA's
U.S.D.A.	USDA
USDA	USDA
USDoE	USDOE
USDOJ	USDOJ
USDP	USDP
USDTV	USDTV
usd	USD
USD	USD
USEER	USEER
USENIX	USENIX
USFbA	USFBA
USFE	USFE
USFF	USFF
USFLPA	USFLPA
USFL	USFL
USFS	USFS
USF	USF
USF&WS	USF and WS
USFWS	USFWS
USFW	USFW
USGA	USGA
U.S.G.S.	USGS
USGS	USGS
U.S. H.R.	USHR
UShs	USH's
Usia	USIA
USIA	USIA
usih	USIH
USIP's	USIP's
USIP	USIP
USISL	USISL
USIS	USIS
USIU	USIU
USJA	USJA
USJ	USJ
USLES	USLES
USLHE	USLHE
USLMRA	USLMRA
USLTA	USLTA
USL	USL
Uslu	USLU
Usmar	USMAR
USMA	USMA
USMC M	USMC
USMCR	USMCR
USMC's	USMC's
USMC	USMC
USMLE	USMLE
USML	USML
USMMA	USMMA
USM	USM
Usna	USNA
USNA	USNA
USNG	USNG
Usnic	USNIC
USNM	USNM
USNO	USNO
USNR	USNR
USNSCS	USNSCS
USNS	USNS
USNTDP	USNTDP
U.S.N.	USN
USN	USN
USOC's	USOC's
USOC	USOC
Usoi	USOI
Usos	USO's
Uso	USO
USO	USO
USPHL	USPHL
USPO	USPO
USPPD	USPPD
U.S.P.Q.	USPQ
USPSA	USPSA
USPs	USP's
USPS	USPS
USPTA	USPTA
USPTO	USPTO
U.S.P.	USP
USP	USP
USRA	USRA
USRC	USRC
USSA	USSA
USSBA	USSBA
USSB	USSB
USSD	USSD
USSF's	USSF's
USSF	USSF
USSR's	USSR's
USSR	USSR
U.S.S.R	USSR
U.S.'s	US's
US's	US's
U.S.S.	USS
USS	USS
Usti	USTI
Ustka	USTKA
USTR's	USTR's
USTR	USTR
UST's	UST's
Usui	USUI
usum	USUM
U. S.	US
U.S.	US
Usut	USUT
USVC	USVC
Usvit	USVIT
USVI	USVI
U.S.V.	USV
USWA	USWA
USWNT's	USWNT's
USWNT	USWNT
U.S.W.	USW
USW	USW
Uta's	UTA's
uta	UTA
Uta	UTA
UTA	UTA
UTB	UTB
Utca	UTCA
UTC	UTC
Utd's	UTD's
Utd	UTD
utea	UTEA
UTEP	UTEP
Utes	UTE's
UTET	UTET
UTF	UTF
Uth	UTH
uti	UTI
Uti	UTI
UTJ	UTJ
UTMB	UTMB
UTMF	UTMF
UTM	UTM
Utne	UTNE
Utnur	UTNUR
Uto	UTO
UTO	UTO
UTPB	UTPB
UTP	UTP
utrci	UTRCI
UTRGV	UTRGV
UTR	UTR
utsav	UTSAV
Utsav	UTSAV
UTSC	UTSC
UTSI	UTSI
UT's	UT's
UTS	UTS
Utsu	UTSU
UTTR	UTTR
U.T.	UT
Utu	UTU
Utva	UTVA
UTVA	UTVA
UTV	UTV
UUA	UUA
UUCP	UUCP
Uuh	UUH
UUKKY	UUKKY
Uul	UUL
Uulu	UULU
UUP	UUP
Uusi	UUSI
UUs	UU's
Uuto	UUTO
UUT	UUT
Uvac	UVAC
UVB	UVB
UVC	UVC
Uvea	UVEA
UVF	UVF
UVIMB	UVIMB
UVI	UVI
uvnitr	UVNITR
Uvo	UVO
UVT	UVT
UVU	UVU
U.V.	UV
UV	UV
UWAP	UWAP
Uwasa	UWASA
UWASA	UWASA
U.W.A.	UWA
UWA	UWA
UWB	UWB
UWC	UWC
UWFi	UWFI
UWF	UWF
UWG	UWG
UWH	UWH
UWI	UWI
UWM's	UWM's
UWP	UWP
UWRF	UWRF
UWSP's	UWSP's
UWSU	UWSU
UW's	UW's
UWS	UWS
UW	UW
UWW	UWW
VASP	VASP
VA's	VA's
V. A.	VA
V.A.	VA
VA	VA
V&A	V and A
Vav	VAV
VAV	VAV
Vay	VAY
VBA	VBA
VBBS	VBBS
VBE	VBE
VBI	VBI
VBM	VBM
VBR	VBR
vb	VB
V. B.	VB
V.B.	VB
VB	VB
VCA's	VCA's
VCA	VCA
VCCS	VCCS
VCDs	VCD's
VCD	VCD
VCE	VCE
VCH	VCH
VCIT	VCIT
VCI	VCI
VCJ	VCJ
V. C. M.	VCM
VCO	VCO
VCP	VCP
VCQ	VCQ
VCRs	VCR's
VCR	VCR
VCSELs	VCSEL's
VCSEL	VCSEL
VCs	VC's
VCS	VCS
VCTs	VCT's
VCT	VCT
VCU	VCU
vc	VC
V. C.	VC
V.C.	VC
VC	VC
VCXIV	VCXIV
VCY	VCY
VDAC	VDAC
vda	VDA
Vda	VDA
VDCs	VDC's
VDC	VDC
vdiq	VDIQ
VDJ	VDJ
VDL's	VDL's
VDL	VDL
vdm	VDM
VDM	VDM
VDP	VDP
VDR	VDR
VDSL	VDSL
VDUP	VDUP
VDU	VDU
V. D.	VD
V.D.	VD
VD	VD
VDV	VDV
V. D. W.	VDW
vez	VEZ
Vez	VEZ
VEZ	VEZ
V.F.A.	VFA
VFA	VFA
VFC	VFC
VFDS	VFDS
V.F.D.	VFD
VFD	VFD
VFIL	VFIL
VFLI	VFLI
VFL's	VFL's
VFL	VFL
VFMC	VFMC
VFM	VFM
vfp	VFP
vfr	VFR
VFR	VFR
VF's	VF's
VFS	VFS
VFTS	VFTS
VFTX	VFTX
VFU	VFU
V. F.	VF
V.F.	VF
VF	VF
VFW	VFW
VFX	VFX
VGA	VGA
V'Ger	VGER
VGIK	VGIK
VGKO	VGKO
VGMA	VGMA
vgmdb	VGMDB
VGMDB	VGMDB
VGM	VGM
VGo	VGO
VGP	VGP
VGSCs	VGSC's
VGSoM	VGSOM
VGTU	VGTU
VGU	VGU
V. G.	VG
V.G.	VG
VG	VG
VGV	VGV
VGX	VGX
VHB	VHB
VHC	VHC
VHD	VHD
VHF	VHF
VHL	VHL
VHP	VHP
VHR	VHR
VHSL	VHSL
VHS	VHS
V. H.	VH
VH	VH
V.I.C.'s	VIC's
Vict	VICT
VICT	VICT
viita	VIITA
vijf	VIJF
vij	VIJ
Vij	VIJ
V.I.P.s	VIP's
VIPs	VIP's
V.I.P.	VIP
VIP	VIP
V. I.	VI
V.I.	VI
V. J. J.	VJJ
VJL	VJL
VJs	VJ's
VJTF	VJTF
V. J.	VJ
V.J.	VJ
VJ	VJ
VKG	VKG
VKIBC's	VKIBC's
V. K. N.	VKN
VKOS	VKOS
VKS	VKS
V. K.	VK
V.K.	VK
VK	VK
Vlah	VLAH
VLA	VLA
VLBA	VLBA
VLBI	VLBI
VLB	VLB
VLCCs	VLCC's
VLCS	VLCS
VLC	VLC
VLDB	VLDB
VLDL	VLDL
vlei	VLEI
VLE	VLE
VLEX	VLEX
VLF	VLF
Vlijt	VLIJT
VLN	VLN
VLQ	VLQ
VLR	VLR
VLSI	VLSI
VLS	VLS
VLT	VLT
V. L.	VL
V.L.	VL
VL	VL
VMAs	VMA's
VMAT	VMAT
VMA	VMA
VMCAS	VMCAS
VMCM	VMCM
VME	VME
VMFM	VMFM
VMF	VMF
VMG	VMG
VMI's	VMI's
VMI	VMI
VMK	VMK
VMM	VMM
VMPS	VMPS
VMS	VMS
VMT	VMT
vm	VM
V. M.	VM
V.M.	VM
VM	VM
VNAF	VNAF
VNAV	VNAV
VNCH	VNCH
VNC	VNC
vner	VNER
V.N.E.	VNE
VNI	VNI
VNO	VNO
VNPT	VNPT
VNQDD	VNQDD
VNR	VNR
VNSA	VNSA
VNS	VNS
VNTH	VNTH
VNTR	VNTR
VNU	VNU
V. N.	VN
V.N.	VN
VN	VN
V.O.	VO
VO	VO
Vov	VOV
VOX's	VOX's
Voz	VOZ
VPAL	VPAL
VPD	VPD
VPH	VPH
vpis	VPIS
V. P. I.	VPI
VPI	VPI
VPLS	VPLS
VPL	VPL
VPM	VPM
VPNs	VPN's
VPN	VPN
VPO's	VPO's
VPP	VPP
VPRO's	VPRO's
VPRO	VPRO
VPS	VPS
vpu	VPU
V. P.	VP
V.P.	VP
VP	VP
VQT	VQT
vq	VQ
VQ	VQ
vrak	VRAK
VRA	VRA
Vrba	VRBA
Vrbuv	VRBUV
VRD	VRD
Vrej	VREJ
vrem	VREM
VRE	VRE
VRF	VRF
Vrin	VRIN
VRI	VRI
vrj	VRJ
VRLA	VRLA
vrn	VRN
vroee	VROEE
vrou	VROU
vrouw	VROUW
Vrouw	VROUW
VRO	VRO
VRR	VRR
Vrsac	VRSAC
VRSA	VRSA
VR's	VR's
VRS	VRS
Vrtis	VRTI's
VRT's	VRT's
VRT	VRT
V&R	V and R
vr	VR
V. R.	VR
V.R.	VR
VR	VR
VRV	VRV
VSANs	VSAN's
VSAN	VSAN
VSAP's	VSAP's
VSATs	VSAT's
VSB's	VSB's
VSB	VSB
VSCP	VSCP
VSC	VSC
VSD	VSD
Vsekh	VSEKH
vse	VSE
VSE	VSE
VSFV	VSFV
VSG	VSG
VSI	VSI
VSM	VSM
VSNL	VSNL
vso	VSO
VSO	VSO
VSPs	VSP's
VSP	VSP
VSS	VSS
VSTM	VSTM
VST	VST
VSU	VSU
vs.	versus
_vs._	versus
VSV	VSV
VSW	VSW
VSX	VSX
vsyo	VSYO
VSZ	VSZ
VTA	VTA
VTB	VTB
VTCO	VTCO
VTD	VTD
VTEC	VTEC
VTE	VT eL
Vtic	VTIC
VTi	VTI
VTL	VTL
VTM	VTM
VTR	VTR
VTSK	VTSK
V&T's	V and T's
VTS	VTS
VTU	VTU
V&T	V and T
VTVL	VTVL
V.T.	VT
VT	VT
VTV	VTV
Vuur	VUUR
VUU	VUU
V.V.B.	VVB
VVCS	VVCS
VVD	VVD
VVIPs	VVIP's
VVI	VVI
VVMC	VVMC
VVO	VVO
VVS	VVS
VVT	VVT
V. V.	VV
V.V.	VV
VV	VV
VWM	VWM
VWR	VWR
VW's	VW's
VWs	VW's
VWS	VWS
VW	VW
VXL	VXL
VXR	VXR
VX	VX
Vyg	VYG
vyr	VYR
vy	VY
VY	VY
vz	VZ
V. Z.	VZ
WAAAAAGH	WAAAAAGH
WAAAF	WAAAF
WAAC	WAAC
WAAF	WAAF
WAAI	WAAI
WAAV	WAAV
Waay	WAAY
WABB	WABB
WABC	WABC
WABD	WABD
WABG's	WABG's
WABG	WABG
W. A. C.	WAC
W.A.C.	WAC
Wa'il	WAIL
WAIO	WAIO
W.A.J.	WAJ
Wakf	WAKF
W.A.K.O.	WAKO
wa'l	WAL
WANFL	WANFL
WAOK	WAOK
waqf	WAQF
waqt	WAQT
Waqt	WAQT
WAQZ	WAQZ
WARH	WARH
W.A.R.	WAR
WASC	WASC
Wasl	WASL
WASL	WASL
W. A. S.	WAS
W.A.S.	WAS
Watfa	WATFA
WATL	WATL
WATW	WATW
wau	WAU
Wau	WAU
WAU	WAU
WAVF	WAVF
WAVM	WAVM
W. A.	WA
W.A.	WA
WA	WA
WAWLI	WAWLI
waw	WAW
WAWZ	WAWZ
WAYH	WAYH
waza	WAZA
Waza	WAZA
WBAL's	WBAL's
WBAM	WBAM
WBA	WBA
WBBL	WBBL
WBBM	WBBM
WBBP	WBBP
WBCA	WBCA
WBCN	WBCN
W.B.C.	WBC
WBC	WBC
WBCY	WBCY
WBEV	WBEV
WBEZ	WBEZ
WBFJ	WBFJ
WBFO	WBFO
WBF	WBF
WBG	WBG
WBHY	WBHY
WBIC	WBIC
WBIL	WBIL
WBJEE	WBJEE
WBKO	WBKO
WBK	WBK
WBLQ	WBLQ
WBME	WBME
WBNI	WBNI
WBNX	WBNX
WBON	WBON
WBO	WBO
WBQC	WBQC
WBRC	WBRC
WBRE	WBRE
WBRO	WBRO
WBRZ	WBRZ
WBs	WB's
WBS	WBS
WBTI	WBTI
WBT's	WBT's
WBT	WBT
WBTW	WBTW
WBTZ	WBTZ
WBUR	WBUR
WBVE	WBVE
WBV	WBV
W. B.	WB
W.B.	WB
WB	WB
WBXH	WBXH
WBZB	WBZB
WBZ	WBZ
WCAA	WCAA
WCAG	WCAG
WCAU	WCAU
WCA	WCA
WCBA	WCBA
WCBN	WCBN
W&CBR	W and CBR
WCBR	WCBR
WCBS	WCBS
WCB	WCB
WCCES	WCCES
WCCG	WCCG
WCCO	WCCO
WCC's	WCC's
WCC	WCC
WCDA	WCDA
WCEO	WCEO
WCFL	WCFL
WCF	WCF
WCG	WCG
WCHA	WCHA
WCHL's	WCHL's
WCHL	WCHL
WCHS	WCHS
WCHV	WCHV
WCIU	WCIU
WCKD	WCKD
WCKY	WCKY
WCLN	WCLN
WCLU	WCLU
WCLV	WCLV
WCL	WCL
WCMA	WCMA
WCMC	WCMC
WCMFA	WCMFA
WCMH	WCMH
WCMR	WCMR
WCM	WCM
WCNB	WCNB
WCOZ	WCOZ
WCPO	WCPO
WCPW	WCPW
WCRC	WCRC
WCRE	WCRE
WCRL	WCRL
WCSA	WCSA
WCSM	WCSM
WCS	WCS
WCTD	WCTD
WCTG	WCTG
W.C.T.U.	WCTU
WCTU	WCTU
WCTV	WCTV
WCT	WCT
WCTX	WCTX
WCVB's	WCVB's
WCVB	WCVB
WCVE	WCVE
WCWA	WCWA
wc	WC
W. C.	WC
W.C.	WC
WC	WC
WCWC	WCWC
WCW	WCW
WCXR	WCXR
WCYB	WCYB
WCZE	WCZE
WDAF	WDAF
WDA	WDA
WDC	WDC
WDDM	WDDM
WDFN	WDFN
WDF	WDF
WDGY	WDGY
WDH	WDH
WDIA	WDIA
WDIF	WDIF
WDIG	WDIG
WDIS	WDIS
WDIV	WDIV
WDJT	WDJT
WDLA	WDLA
WDL	WDL
WDM	WDM
WDNN	WDNN
WDNS	WDNS
WDNT	WDNT
WDOK	WDOK
WDO	WDO
WDRE	WDRE
WDR	WDR
WDSE	WDSE
WDSN	WDSN
WDSO	WDSO
WDSU	WDSU
WDS	WDS
WDTM	WDTM
WDUQ	WDUQ
WDVE	WDVE
WDVR	WDVR
W. D.	WD
W.D.	WD
WDWS	WDWS
WDW	WDW
WDXZ	WDXZ
WDYZ	WDYZ
W. E. B.	WEB
W.E.B.	WEB
W. E. H.	WEH
W.E.H.	WEH
WEVD	WEVD
WEVV	WEVV
W. E.	WE
W.E.	WE
WEZQ	WEZQ
WFAA	WFAA
WFAL	WFAL
WFAN	WFAN
WFB	WFB
WFCA	WFCA
WFC	WFC
WFDC	WFDC
WFDD	WFDD
WFDF	WFDF
WFDU	WFDU
WFD	WFD
WFGF	WFGF
WFHE	WFHE
W.F.H.	WFH
WFH	WFH
WFIKKN	WFIKKN
WFIL	WFIL
WFIRST	WFIRST
WFL's	WFL's
WFL	WFL
WFLX	WFLX
WFMT	WFMT
WFMU	WFMU
W. F. M.	WFM
WFM	WFM
WF&NW	WF and NW
WFNZ	WFNZ
WFOY	WFOY
WFPC	WFPC
WFPF	WFPF
WFPMA	WFPMA
W.F.P.	WFP
WFP	WFP
WFSBP	WFSBP
WFS	WFS
WFTDA	WFTDA
WFTM	WFTM
WFTV	WFTV
WFT	WFT
WFVA	WFVA
W&F	W and F
WFWA	WFWA
W. F.	WF
W.F.	WF
WF	WF
WFWM	WFWM
WFXR	WFXR
wga	WGA
WGA	WGA
WGBH	WGBH
WGBI	WGBI
W. G. B.	WGB
WGB	WGB
WGCB	WGCB
W.G.C.	WGC
WGC	WGC
WGEM	WGEM
WGFT	WGFT
WGGH	WGGH
WGHP	WGHP
WGH	WGH
WGHW	WGHW
WGI	WGI
WGN's	WGN's
WGNT	WGNT
wgn	WGN
WGN	WGN
WGOK	WGOK
WGO	WGO
WGP	WGP
WGPX	WGPX
WGRP	WGRP
WGRT	WGRT
WGRV	WGRV
WGSA	WGSA
WGSS	WGSS
WGS	WGS
WGUN	WGUN
wg	WG
W. G.	WG
W.G.	WG
WG	WG
WGWW	WGWW
WGZR	WGZR
W.H.B.	WHB
WHCA	WHCA
WHCB	WHCB
WHCC	WHCC
W. H. C.	WHC
W.H.C.	WHC
WHC	WHC
WHDG	WHDG
WHDI	WHDI
W.H.D.	WHD
WHEC	WHEC
WHFA	WHFA
WHFM	WHFM
WHFS	WHFS
WHHS	WHHS
W.H.H.	WHH
WHJA	WHJA
W.H.J.	WHJ
WHJY	WHJY
WHKT	WHKT
WHL's	WHL's
WHL	WHL
WHNO	WHNO
WHP	WHP
WHRC	WHRC
WHSN	WHSN
WHSS	WHSS
W.H.S.	WHS
WHS	WHS
W. H. T.	WHT
WHTZ	WHTZ
W&H	W and H
W. H.	WH
W.H.	WH
WH	WH
Whyld	WHYLD
WHYT	WHYT
W.I.B.C.	WIBC
Wica	WICA
wici	WICI
WIC's	WIC's
WICU	WICU
Wif	WIF
WIF	WIF
WIJD	WIJD
Wijk	WIJK
WIP	WIP
W.I.S.E.	WISE
W.I.T.C.H.	WITCH
Wiwa	WIWA
W. I.	WI
WIXY's	WIXY's
WJAL	WJAL
WJAR	WJAR
wjaz	WJAZ
WJBC	WJBC
WJBF	WJBF
WJBK	WJBK
WJBR	WJBR
WJCI	WJCI
WJC	WJC
WJEC	WJEC
WJEF	WJEF
WJER	WJER
WJET	WJET
W. J. J. O.	WJJO
W.J.J.O.	WJJO
WJJZ	WJJZ
WJKA's	WJKA's
WJKA	WJKA
WJKS	WJKS
WJLA	WJLA
WJMK	WJMK
WJM	WJM
WJOI	WJOI
WJRD	WJRD
WJR	WJR
WJSC	WJSC
W&J's	W and J's
WJTD	WJTD
WJUX	WJUX
W&J	W and J
W. J.	WJ
W.J.	WJ
WJ	WJ
WJXX	WJXX
WJYL	WJYL
WJYM	WJYM
WJZA	WJZA
WJZJ	WJZJ
WJZ	WJZ
WKAG	WKAG
WKAQ	WKAQ
WKAR	WKAR
WKA	WKA
WKBD	WKBD
WKBF's	WKBF's
WKB	WKB
WKBW	WKBW
W. K. C.	WKC
WKDM	WKDM
WKDN	WKDN
WKDZ	WKDZ
WKFS	WKFS
W.K.H.	WKH
WKH	WKH
WKIK	WKIK
WKIP	WKIP
WKKB	WKKB
WKKD	WKKD
WKKZ	WKKZ
WKLH	WKLH
WKNDS	WKNDS
WKN	WKN
WKQI	WKQI
WKRR	WKRR
WKSE	WKSE
WKSM	WKSM
WKSU	WKSU
WKTU's	WKTU's
WKTU	WKTU
W.K.V.	WKV
W. K.	WK
W.K.	WK
WKXJ	WKXJ
WKX	WKX
WKYS's	WKYS's
WKYT	WKYT
WKY	WKY
W.L.A.K.	WLAK
WLB	WLB
WLCH	WLCH
W&LE	W and LE
Wley	WLEY
WLGH	WLGH
WLH	WLH
WLII	WLII
WLIR	WLIR
WLJY	WLJY
WLKT	WLKT
WLKY	WLKY
WLLM	WLLM
WLNP	WLNP
WLNQ	WLNQ
WLNS	WLNS
WLPA	WLPA
WLPR	WLPR
WLPWR	WLPWR
wlrs	WLRS
WLSG	WLSG
WLS	WLS
WLTM	WLTM
WLUK's	WLUK's
WLUK	WLUK
WLWC	WLWC
W. L.	WL
W.L.	WL
WL	WL
WLW	WLW
WLYH's	WLYH's
WLYN	WLYN
WLY	WLY
WLZK	WLZK
WMAC	WMAC
WMAG	WMAG
WMAP	WMAP
WMAQ	WMAQ
WMATA's	WMATA's
WMATA	WMATA
W.M.A.	WMA
WMA	WMA
WMAZ	WMAZ
WMBG	WMBG
WMCAT	WMCAT
WMCA	WMCA
WMDB	WMDB
WMDI	WMDI
WMD	WMD
WMEE	WMEE
WMEN	WMEN
WMET	WMET
WME	WME
WMEX	WMEX
WMFC	WMFC
WMFM	WMFM
WMFP	WMFP
W.M.F.	WMF
WMF	WMF
WMGF	WMGF
WMG	WMG
WMGY	WMGY
WMHG	WMHG
WMHT	WMHT
WMIX	WMIX
WMJR	WMJR
WMJZ	WMJZ
WMKQ	WMKQ
WMKW	WMKW
wml	WML
WMLW	WMLW
WMLY	WMLY
WMMS	WMMS
W. M. M.	WMM
WMNF	WMNF
WMN	WMN
WMOB	WMOB
WMO	WMO
WMRA	WMRA
WMRO	WMRO
WMSG	WMSG
W.M.S.	WMS
WMS	WMS
WMTS	WMTS
WMT	WMT
WMTW	WMTW
WMUB	WMUB
WMU	WMU
WMVM	WMVM
WMV	WMV
W&M	W and M
W. M.	WM
W.M.	WM
WM	WM
WMWM	WMWM
WMXB	WMXB
WMX	WMX
WMYE	WMYE
WMYL	WMYL
WNAK	WNAK
W.N.B.A.	WNBA
WNBA	WNBA
WNBC	WNBC
WNBL	WNBL
WNBR	WNBR
WNB	WNB
WNCN	WNCN
WNC	WNC
WNCX	WNCX
WND	WND
WNED	WNED
WNEL	WNEL
WNEM	WNEM
WNEP	WNEP
WNET	WNET
WNEW's	WNEW's
WNEW	WNEW
WNFM	WNFM
WNGL	WNGL
WNIT	WNIT
WNJN	WNJN
WNJO	WNJO
WNJY	WNJY
WNK	WNK
WNLO	WNLO
WNLU	WNLU
WNL	WNL
WNMX	WNMX
WNO	WNO
WNPT	WNPT
WNRN	WNRN
WNR's	WNR's
WNRV	WNRV
WNSH	WNSH
WNSR	WNSR
WNTM	WNTM
WNT	WNT
WNUA	WNUA
WNUF	WNUF
WNUSP	WNUSP
WNWBL	WNWBL
W. N.	WN
W.N.	WN
WN	WN
WNWO	WNWO
WNWS	WNWS
WNW	WNW
WNYA	WNYA
WNYC's	WNYC's
WNYC	WNYC
WNYM	WNYM
WNY	WNY
WNYZ	WNYZ
wnzaa	WNZAA
WOAA	WOAA
WOAK	WOAK
WOA	WOA
WOC	WOC
W&OD	W and OD
W.O.G.	WOG
WOGX's	WOGX's
WOJG	WOJG
WOLH	WOLH
WOOM	WOOM
WOPC	WOPC
Worh	WORH
WOSM	WOSM
W. O.	WO
W.O.	WO
WOWOW	WOWOW
WOXY	WOXY
WOZN	WOZN
WPAC	WPAC
WPA	WPA
WPBC	WPBC
WPBSA	WPBSA
WPBS	WPBS
WPBT	WPBT
W. P. C.	WPC
WPC	WPC
WPDH	WPDH
WPD	WPD
WPFF	WPFF
WPFL	WPFL
WPF	WPF
WPGC	WPGC
WPHL	WPHL
WPH	WPH
WPIAL	WPIAL
WPI	WPI
WPIX	WPIX
WPLA	WPLA
WPLG	WPLG
WPLS	WPLS
WPMW	WPMW
WPO	WPO
WPPT	WPPT
WPP	WPP
WPRI	WPRI
WPRO	WPRO
WPRP	WPRP
WPSC	WPSC
WPSL	WPSL
WPS	WPS
WPTB	WPTB
WPTD's	WPTD's
wpt	WPT
WPT	WPT
WPTY	WPTY
W. P. U.	WPU
wp	WP
W. P.	WP
W.P.	WP
WP	WP
WPXN	WPXN
WPYR	WPYR
WQDE	WQDE
WQHT	WQHT
WQIV	WQIV
WQLR	WQLR
WQLZ	WQLZ
WQMS	WQMS
WQOK	WQOK
WQSO	WQSO
WQSX	WQSX
WQ	WQ
WQXI	WQXI
WQXR	WQXR
W. R. A. S.	WRAS
WRAT	WRAT
WRBU	WRBU
WRCB	WRCB
WRCN	WRCN
WRC	WRC
WRDL	WRDL
Wrec	WREC
WRFD	WRFD
WRFK	WRFK
WRFM	WRFM
WRFX	WRFX
WRGO	WRGO
WRGP	WRGP
W. R. G.	WRG
WRHA	WRHA
WRHC	WRHC
WRHI	WRHI
W.R.I.	WRI
WRKA	WRKA
WRKO	WRKO
WRKT	WRKT
W.R.K.	WRK
WRKY	WRKY
WRNS	WRNS
WRN	WRN
WRNY	WRNY
WRNZ	WRNZ
WROJ	WROJ
WROK	WROK
WROO	WROO
WRPT	WRPT
WRQQ	WRQQ
WRTA	WRTA
WRTC	WRTC
WRUV	WRUV
WRU	WRU
WRVL	WRVL
WRVS	WRVS
WRWB	WRWB
W. R.	WR
W.R.	WR
WR	WR
W.R.W.	WRW
WRXT	WRXT
WSAR	WSAR
WSAV	WSAV
W.S.A.	WSA
WSA	WSA
WSAZ	WSAZ
WSBG	WSBG
WSBM	WSBM
WSBT	WSBT
WSB	WSB
WSCA's	WSCA's
WSCR	WSCR
W. S. C.	WSC
WSC	WSC
WSDD	WSDD
WSDG	WSDG
WSDOT	WSDOT
WSDP	WSDP
WSDR	WSDR
WSEG	WSEG
WSEK	WSEK
WSE	WSE
WSFA	WSFA
WSFL	WSFL
WSFM	WSFM
WSFS	WSFS
WSFX	WSFX
WSGE	WSGE
WSGW	WSGW
WSHL	WSHL
WSHU	WSHU
WSH	WSH
WSIPC	WSIPC
WSIS	WSIS
WSJM	WSJM
WSJO	WSJO
WSJ	WSJ
WSLU	WSLU
WSL	WSL
WSMK	WSMK
W.S.M.	WSM
WSM	WSM
WSNJ	WSNJ
WSNS	WSNS
WSNT	WSNT
WSN	WSN
WSOF	WSOF
WSOPE	WSOPE
WSOP's	WSOP's
WSOP	WSOP
WSORR	WSORR
WSO	WSO
WSOY	WSOY
WSPA	WSPA
WSPC	WSPC
WSPD	WSPD
WSPN	WSPN
WSPS	WSPS
WSPU	WSPU
WSP	WSP
WSRA	WSRA
WSRE's	WSRE's
WSRF	WSRF
WSSA	WSSA
WSSCC	WSSCC
WSSSA	WSSSA
WSS	WSS
WSTE	WSTE
WSTR	WSTR
WSUA	WSUA
WSUD	WSUD
WSUE	WSUE
WSUS	WSUS
WSU	WSU
WSV	WSV
WSVZ	WSVZ
WSWI	WSWI
ws	WS
W. S.	WS
W.S.	WS
WS	WS
WSW	WSW
WSYN	WSYN
WSYX	WSYX
WTAA	WTAA
WTAE	WTAE
WTAF	WTAF
WTAG	WTAG
WTAM's	WTAM's
W. T. A.	WTA
WTA	WTA
WTAW	WTAW
WTCC	WTCC
W. T. C.	WTC
W.T.C.	WTC
WTC	WTC
WTDY	WTDY
WTEL	WTEL
WTEV's	WTEV's
WTEV	WTEV
WTF	WTF
WTGB	WTGB
WTHR's	WTHR's
WTHS	WTHS
WTIU	WTIU
WTI	WTI
WTIX	WTIX
WTKG	WTKG
WTKO	WTKO
WTKR	WTKR
WTKS	WTKS
WTLS	WTLS
WTMA	WTMA
WTNH	WTNH
WTN	WTN
WTOP	WTOP
WTO's	WTO's
WTOS	WTOS
WTO	WTO
WTPA	WTPA
WTPQ	WTPQ
WTR	WTR
WTs	WT's
WTS	WTS
WTTF	WTTF
WTTM	WTTM
WTTs	WTT's
WTT	WTT
WTTW	WTTW
WTTZ	WTTZ
WTVA	WTVA
WTVC	WTVC
WTVD	WTVD
WTVI	WTVI
WTVM	WTVM
WTVU	WTVU
WTVW	WTVW
WTVX	WTVX
WTWF	WTWF
W. T.	WT
W.T.	WT
WT	WT
WTX	WTX
WUAB	WUAB
WUAP	WUAP
WUAs	WUA's
WUC	WUC
Wudl	WUDL
Wuhr	WUHR
Wuhu	WUHU
WUKB	WUKB
WUPG	WUPG
WUPN	WUPN
WUPZ	WUPZ
Wu's	WU's
WUSW	WUSW
WUTK	WUTK
WUVC	WUVC
wuv	WUV
W. U.	WU
Wuz	WUZ
WVa	WVA
WVBX	WVBX
WVCA	WVCA
WVIT	WVIT
WVJC	WVJC
WVJP	WVJP
WVLZ	WVLZ
WVNI	WVNI
WVNY	WVNY
W. V. O.	WVO
WVO	WVO
WVPA	WVPA
WVPO	WVPO
WVSSAC	WVSSAC
WVSU	WVSU
WVTU's	WVTU's
WVTU	WVTU
WVUE	WVUE
WVU	WVU
WVUW	WVUW
W. V.	WV
W.V.	WV
WV	WV
WWAA	WWAA
WWAMI	WWAMI
WWASP	WWASP
WWA	WWA
WWAX	WWAX
WWBZ	WWBZ
WWCD	WWCD
WWC	WWC
WWDB's	WWDB's
WWDC	WWDC
WWDR	WWDR
WWD	WWD
WWE's	WWE's
Wwe	WWE
WWE	WWE
WWF's	WWF's
WWF	WWF
WWGC	WWGC
WWHT	WWHT
WWHW	WWHW
WWIS	WWIS
WWJP	WWJP
WWKB	WWKB
WWKL	WWKL
WWML	WWML
WWMM	WWMM
WWMX	WWMX
WWMY	WWMY
WWN	WWN
WWNW	WWNW
WWNY	WWNY
WWOX	WWOX
WWPG	WWPG
WWP	WWP
WWPW	WWPW
WWRFC	WWRFC
WWRV	WWRV
WWSS	WWSS
WWS	WWS
WWTI's	WWTI's
WWTI	WWTI
WWTN	WWTN
WWU	WWU
WWVA	WWVA
WWVR	WWVR
WWV	WWV
WWWF	WWWF
WWWQ's	WWWQ's
W. W.	WW
W.W.	WW
WW	WW
WWW	WWW
WWWW	WWWW
WWYD	WWYD
WXB	WXB
WXCN	WXCN
WXDU	WXDU
WXEL	WXEL
WXIL	WXIL
WXIN's	WXIN's
WXIN	WXIN
WXJM's	WXJM's
WXJ	WXJ
WXN	WXN
WXQW	WXQW
WXTG	WXTG
WXW	WXW
wx	WX
WX	WX
W.Y.	WY
WY	WY
wyzc	WYZC
WZBC	WZBC
WZFG	WZFG
WZFT	WZFT
WZGC	WZGC
WZJQ	WZJQ
WZKC	WZKC
WZLR	WZLR
WZLX	WZLX
WZRB	WZRB
WZRD	WZRD
WZST	WZST
W. Z.	WZ
WZ	WZ
WZX	WZX
WZZM	WZZM
WZZX	WZZX
xbg	XBG
XBMC	XBMC
XBM	XBM
Xbra	XBRA
XBRL	XBRL
XBV	XBV
XCB	XCB
XCE	XCE
XCMS	XCMS
XCOM	XCOM
XCOR	XCOR
xCo	XCO
XCR	XCR
XCT	XCT
XCVI	XCVI
XCV	XCV
X. C.	XC
XC	XC
XCX	XCX
xda	XDA
XDDM	XDDM
XDH	XDH
XDK	XDK
XDRs	XDR's
XDR	XDR
XD's	XD's
XDS	XDS
X. D.	XD
XD	XD
Xfce	XFCE
XFC	XFC
XFDL	XFDL
XFD	XFD
XFL	XFL
XFM	XFM
XFS	XFS
XFU	XFU
xf	XF
X.F.	XF
XF	XF
XHVFC	XHVFC
xh	XH
X. H.	XH
XH	XH
XJD	XJD
XJ	XJ
XKE	XKE
XKL	XKL
xk	XK
XK	XK
XL	XL
XMB	XMB
xmc	XMC
xml	XML
XML	XML
XMMS	XMMS
XMPP	XMPP
XMP	XMP
XMRV	XMRV
XMSN	XMSN
XM's	XM's
XMU	XMU
X.M.	XM
XM	XM
XN	XN
xO	XO
X.O.	XO
XO	XO
XPA	XPA
XPD	XPD
XPe	XPE
XPL	XPL
XPN	XPN
XP's	XP's
XPS	XPS
XPT	XPT
XPW	XPW
XP	XP
X.Q.	XQ
XQ	XQ
XRCC	XRCC
XRCO	XRCO
XRDS	XRDS
XRD	XRD
XRE	XRE
XR	XR
XSD	XSD
XSi	XSI
XSI	XSI
XSLT	XSLT
xsr	XSR
XS	XS
XTB	XTB
XTC	XTC
XTG	XTG
XTwas	XTWA's
xt	XT
XT	XT
XVAS	XVA
XWA	XWA
XWB	XWB
XWF	XWF
XWIS	XWIS
X. W.	XW
XYNU	XYNU
XYP	XYP
xy	XY
XY	XY
xyz	XYZ
xyZ	XYZ
XYZ	XYZ
XZ	XZ
Y. A.	YA
Y.A.	YA
YBA	YBA
YBL	YBL
YBNL	YBNL
YBN	YBN
YBR	YBR
YBX	YBX
Y. B.	YB
Y.B.	YB
YB	YB
YBYS	YBYS
YCC	YCC
YCD	YCD
ycia	YCIA
ycie	YCIE
YCL	YCL
YCO	YCO
YCU	YCU
YCV	YCV
yc	YC
Y. C.	YC
Y.C.	YC
YC	YC
YCYW	YCYW
YDA	YDA
Ydby	YDBY
Yde	YDE
YDG	YDG
YdiB	YDIB
YDK	YDK
YDNC	YDNC
yd	YD
Y. D.	YD
Y.D.	YD
YD	YD
Y.E.	YE
YFCMD	YFCMD
YFCs	YFC's
YFCU	YFCU
YFC	YFC
yfle	YFLE
YF&R	YF and R
YF	YF
YGB	YGB
YGEX	YGEX
YGLA	YGLA
YGL	YGL
YG's	YG's
yg	YG
Y. G.	YG
Y.G.	YG
YG	YG
YHA	YHA
YHWH	YHWH
Y. H.	YH
YH	YH
YIF	YIF
YIG	YIG
YITP	YITP
Y. I.	YI
Y.I.	YI
YJO	YJO
yj	YJ
Y. J.	YJ
YJ	YJ
Ykt	YKT
Y. K.	YK
Y.K.	YK
YK	YK
YKY	YKY
Yle	YLE
YLE	YLE
YLF	YLF
yl	YL
Y. L.	YL
YL	YL
YMCA's	YMCA's
Y.M.C.A.	YMCA
YMCA	YMCA
YMF	YMF
Ymke	YMKE
Y.M.M.	YMM
YMM	YMM
YMO	YMO
ym	YM
Y. M.	YM
YM	YM
yndi	YNDI
Yndi	YNDI
yne	YNE
Yngve	YNGVE
Ynis	YNI's
YNK	YNK
YNU	YNU
yn	YN
Yn	YN
Y. N.	YN
Y.N.	YN
YN	YN
Y.O.	YO
YO	YO
ypa	YPA
YPC	YPC
YPF	YPF
YPG	YPG
YPM	YPM
YPO	YPO
Y.P.P.	YPP
YPP	YPP
Y.P.S.	YPS
YPT	YPT
YPU	YPU
Y.P.	YP
YP	YP
Y. Q.	YQ
YQ	YQ
yra	YRA
Yra	YRA
YRC	YRC
YRF	YRF
YRK	YRK
YRM	YRM
YRT	YRT
Y&R	Y and R
YSK'da	YSKDA
YSK'ya	YSKYA
YSK	YSK
YSL	YSL
YSRCP	YSRCP
YSR	YSR
YSU's	YSU's
YSU	YSU
Ys	Y's
Y.S.	YS
YS	YS
YSY	YSY
yta	YTA
YTB	YTB
Ytre	YTRE
YTS	YTS
YTV's	YTV's
YTV	YTV
Y&T	Y and T
Y. T.	YT
Y.T.	YT
YT	YT
Y. V.	YV
YWCA	YWCA
YWC	YWC
Y. W.	YW
Y.Y.	YY
Z. A. B.	ZAB
Z. A.	ZA
Z.A.	ZA
ZBC	ZBC
ZBS	ZBS
ZB	ZB
ZCE	ZCE
ZCGWM	ZCGWM
ZCMI	ZCMI
ZCTA	ZCTA
ZCY	ZCY
ZC	ZC
Zdar	ZDAR
zda	ZDA
ZDF	ZDF
ZDR	ZDR
Z.E.R.O.	ZERO
ZFC	ZFC
ZFK	ZFK
ZFM	ZFM
ZFP	ZFP
ZFS	ZFS
ZFX	ZFX
ZF	ZF
ZGE	ZGE
ZGI	ZGI
zg	ZG
Z.G.	ZG
ZG	ZG
zh	ZH
Z. H.	ZH
Z.H.	ZH
ZH	ZH
zijn	ZIJN
zij	ZIJ
Zij	ZIJ
Z. I.	ZI
Z. J.	ZJ
ZKK	ZKK
ZKM	ZKM
Z.K.	ZK
Z.L.	ZL
Z.M.	ZM
ZNA	ZNA
ZNF	ZNF
ZNK	ZNK
ZnO	ZNO
ZNW	ZNW
ZPAP	ZPAP
Zpav	ZPAV
ZPAV	ZPAV
ZPA	ZPA
ZPK	ZPK
Z.P.	ZP
ZP	ZP
ZQ	ZQ
ZRC	ZRC
ZrI	ZRI
ZRK	ZRK
ZSC	ZSC
ZSE	ZSE
ZSF	ZSF
ZSG's	ZSG's
ZSIS	ZSIS
ZSL	ZSL
ZSO	ZSO
ZSSS	ZSSS
Zsuzsa	ZSUZSA
ZTE	ZTE
ZWYCI	ZWYCI
Z.W.	ZW
Z.X.V.	ZXV
Z.X.	ZX
ZYF	ZYF
Z. Y.	ZY
Z.Y.	ZY
Z. Z.	ZZ
Z.Z.	ZZ
